text	label
What is the difference between a var and val definition in Scala?	scala
In Scala, can I override a concrete field containing a list and append something to it in the subclass?	scala
Finding elements in a scala list and also know which predicate has been satisfied	scala
Practical examples of using symbols in Scala?	scala
Mapping over sublists in scala	scala
Scala remote actors	scala
Include jar file in Scala interpreter	scala
EBNF to Scala parser combinator	scala
short way to breakOut to specific collection type?	scala
How to limit concurrency when using actors in Scala?	scala
How would I express this in Scala?	scala
How to implement efficient sorting algorithms for multiple processors with Scala?	scala
How do you define an @interface in Scala?	scala
parsing recursive structures in scala	scala
Is scala.net production ready?	scala
Scala equivalent to C#'s Expression API	scala
scala syntax highlighting in bluefish	scala
Scala match decomposition on infix operator	scala
Static nested class visibility issue with Scala / Java interop	scala
How well does java and scala Work together?	scala
Is there an efficiency penalty when using Scala inner functions within non-tail recursive functions?	scala
How does Scala XML support work?	scala
How can I get the max of an arbitrary property from a list in Scala?	scala
Is there potential starvation in this code or is it just me?	scala
Scala import java package appending com	scala
Editor does not contain a main type	scala
scala mailbox size limit	scala
"nested CPS ""reset"""	scala
How to use SBT (Simple Build Tool) with Google App Engine?	scala
Scala: String Chomp	scala
scala compilation problem - with java libs	scala
scala event swing :: chicken or egg	scala
Scala Regex Multiple Block Capturing	scala
Using Undercover with ScalaTest and Mavern	scala
Is there an implementation of rapid concurrent syntactical sugar in scala? eg. map-reduce	scala
Java <-> Scala interop: transparent List and Map conversion	scala
How to define accessor method for default constructor parameter?	scala
Scala Actors with Java interop to underlying COM libraries	scala
Construct a java.util.List from a java.util.Set in Scala	scala
Set that match both arrays in Scala	scala
scala: annotating accessor methods	scala
How to copy a list in Scala	scala
Refactoring val to method results in compile-time error	scala
What's so great about Scala?	scala
How can I use map and receive an index as well in Scala?	scala
Is there a problem-free way to run Scala unit tests in Eclipse integrated nicely?	scala
Is there a Scala command-line debugger?	scala
Accessing type members outside the class in Scala	scala
Referring to a Enumeration Value type in a method signature	scala
When to use the equals sign in a Scala method declaration?	scala
Can I zip more than two lists together?	scala
Scala's existential types	scala
Pattern matching a String as Seq[Char]	scala
How to tackle Scala source incompatibilities in 2.8.0?	scala
function working on functions of Array[T] or List[T] or Iterable[T]	scala
Handling properties in Scala	scala
Does Scala's BigDecimal violate the equals/hashCode contract?	scala
Default value for generic data structure	scala
How the Scala script that reads 5G log file from network drive should be modified in order to read last x lines (like 'tail' in Unix)?	scala
So I compiled something with maven, now what do I do with it?	scala
How to define a cyclic type definition?	scala
Enterprise Scala	scala
GUI programming in Scala	scala
Is there any Scala built-in class for capturing an external process's output?	scala
Self-modify the classpath within a Scala script?	scala
why in SPOJ we can't code in SCALA programming language?	scala
Common idiom in Java to Scala, traverse/Iterate Java list into Scala list	scala
What is the most efficient way to create emtpy ListBuffer ?	scala
Scala Catalog of functional Design Pattern	scala
How can I identify a remote actor?	scala
What ORMs work well with Scala?	scala
Implement a method using a function value in Scala	scala
Limiting recursion depth in Scala	scala
When is @uncheckedVariance needed in Scala, and why is it used in GenericTraversableTemplate?	scala
Scala: How do I dynamically instantiate an object and invoke a method using reflection?	scala
Which is the best Scala IDE?	scala
"""dangling"" local blocks in scala"	scala
Why is this Option transformed to a String? [Scala]	scala
Drawbacks to using Lift (Scala-based framework) for webservices?	scala
How can I convert a Java Iterable to a Scala Iterable?	scala
scala: traits and abstract methods override	scala
How do I implicitly convert Tuples to vector in Scala	scala
scala specs don't exit when testing actors	scala
Alternative to anonymous functions for lazy evaluation in Scala?	scala
How to write a proper null-safe coalescing operator in scala?	scala
how to read immutable data structures from file in scala	scala
What are good application containers for mid-tier services for scala?	scala
What is the _root_ package in Scala?	scala
Dependency between operations in scala actors	scala
Derived Scala case class with same member variables as base	scala
When should I use package and when object in Scala?	scala
Does the @inline annotation in Scala really help performance?	scala
Scala Concurrency slowing down	scala
Spurious ambiguous reference error in Scala 2.7.7 compiler/interpreter?	scala
Using scala actor framework as fork-join computation?	scala
Remove Characters from the end of a String Scala	scala
How can I create a typed Tuple2 from Java / Spring?	scala
What replaces class variables in scala ?	scala
Use-cases for Streams in Scala	scala
How to mock a method with functional arguments in Scala?	scala
Where case classes should NOT be used in Scala ?	scala
Scala Actors - Worst practices?	scala
How to count rows in Lift (Scala's web framework)	scala
How to split a Scala script into multiple files	scala
Substitute values in a string with placeholders in Scala	scala
What type of webapp is the sweet spot for Scala's Lift framework?	scala
Scala: How to get class of mixin composition?	scala
pass variable number of arguments in scala (2.8) case class to parent constructor	scala
scala anonymous function syntax	scala
Scala profiler?	scala
Using Option all over the place feels a bit awkward. Am I doing something wrong?	scala
Scala: What is the right way to build HashMap variant without linked lists ?	scala
How to curry a function in Scala	scala
making a GET request to a webservice from the playframework 2.0	scala
Infix operators in Scala and Jython	scala
can't extend two traits that have a method with the same signature?	scala
Parsing of binary data with scala	scala
Type parameters versus member types in Scala	scala
Scala XML \\ copies xmlns attribute. Why and how can I stop it?	scala
scala reflection: getDeclaringTrait ?	scala
Good Scala slides and snippets?	scala
Problems with Scala Swing library	scala
Repeating a List in Scala	scala
Can Scala allow free Type Parameters in arguments (are Scala Type Parameters first class citizens?)?	scala
calling multiple functions with same instance in scala	scala
Scala: How do I cast a variable?	scala
Scala lift framework, ajax form that submits multiple values?	scala
Sleeping actors?	scala
How can I match a function signature without getting type erasure compiler warnings in Scala.	scala
How to set an expected exception using Scala and JUnit 4	scala
Scala - can yield be used multiple times with a for loop?	scala
`sbt package` results in huge war file - how to make it smaller?	scala
How should I think about Scala's Product classes?	scala
Scala - which characters can I omit	scala
Question on Scala Abstract Type	scala
How to eliminate stack trace when running Specs through SBT?	scala
scala -> use .net (linq) and java (various frameworks) in the same program?	scala
Extracting nodes only when they have specific attributes with specific values	scala
Is it possible to specify an anonymous function's return type, in Scala?	scala
Remove duplicates in entries, scala way	scala
scala turning an Iterator[Option[T]] into an Iterator[T]	scala
How do I get around type erasure on Scala? Or, why can't I get the type parameter of my collections?	scala
What are the precise rules for when you can omit parenthesis, dots, braces, = (functions) etc?	scala
scala Iterable#map vs. Iterable#flatMap	scala
Idiomatic IO with scala	scala
How can I create a parser combinator in which line endings are significant?	scala
Scala: how to create XML nodes from some collection	scala
Overriding Scala Enumeration Value	scala
Define Self referencing scala class(recrusive class)	scala
How to extend Java interface containing generic methods in Scala	scala
UTF 8 from Oracle tables	oracle
Oracle requests proxy	oracle
In SQL*Plus, how do I change the prompt to show the connected user and database?	oracle
Oracle 10g PL/SQL- Select results as update column values	oracle
Oracle can I use scalar functions in WHERE Clause? or a NULL issue	oracle
Is it possible to kill a single query in oracle without killing the session?	oracle
Adding Sort Keys and Filter to Oracle Stored Procedure	oracle
Does SQLDeveloper support executing scripts?	oracle
perl JOIN-like behavior in Oracle?	oracle
Oracle 10 optimizer from RULE to COST: why?	oracle
SQL Compare-Like tool for Oracle?	oracle
SELECT * breaks when adding columns in Oracle Application Express (ApEx) 3.0	oracle
How do I escape a reserved word in oracle	oracle
Oracle stored procedures, SYS_REFCURSOR and NHibernate	oracle
Losing decimals when using Oracle SDO_POINT in a view	oracle
Hinky Oracle Connection (TNSNAMES.ora Help)	oracle
Why oracle does not have autoincrement feature for primary keys?	oracle
What are some good Oracle Db maintenance Tools.	oracle
How to extract data from a LONG column holding XML strings	oracle
Understanding the results of Execute Explain Plan in Oracle SQL Developer	oracle
"Is there an open-source SQL database that has the concept of Oracle's ""rowid"" pseudo-column?"	oracle
Oracle load spikes couple hours after startup.	oracle
Predicting Oracle Table Growth	oracle
Index not used due to type conversion?	oracle
How to execute an .SQL script file using c#	oracle
Why does running a script from SQLPlus not require a password?	oracle
Moving Data from SQL Server to Oracle Repeatedly	oracle
TimeStamp in Control File	oracle
Oracle Trigger: raise_application_error	oracle
SSIS Oracle Parameter Mapping	oracle
What's the equivalent of Oracle's to_char in AS400 DB2 SQL syntax?	oracle
Select count(*) from multiple tables	oracle
How can I get rid of dynamic SQL	oracle
How to get values of bind parameters from Oracle JDBC PreparedStatement object	oracle
Oracle optimizing query involving date calculation	oracle
How to split Oracle sql statements for ADO.NET	oracle
Deleting a LOT of data in Oracle	oracle
Getting ORA Oracle error code using PHP function oci_connect?	oracle
Help optimize an Oracle query?	oracle
How to disable XML DTD validation in Oracle DB?	oracle
Why would a database trigger be invalid in an oracle DB?	oracle
Find duplicate/repeated rows in hierarchical sql	oracle
Using Oracle ref cursor in Java without Oracle dependency	oracle
Oracle - Is there any effects of not having a primary key on  a table ?	oracle
What are the benefits of using Oracle Designer?	oracle
How to determine an Oracle query without access to source code?	oracle
How to limit RAM usage in Oracle 9	oracle
Is it recommended practice to use uniform extent sizes in Oracle tablespaces?	oracle
Windows Service in .net Cannot See TNS Names	oracle
In Oracle, is starting the SQL Query's WHERE clause with 1=1 useful?	oracle
How can I clean up dead connections using Oracle?	oracle
Database design - Should a Date be used as part of a primary key	oracle
ORA-00933: SQL command not properly ended	oracle
How to get Oracle create table statement in SQL*Plus	oracle
System.Data.OracleClient: How can I mock/fake/stub OracleException?	oracle
Oracle unique constraint with where clause	oracle
Why  is Oracle's to_char() function adding spaces?	oracle
oracle materialized view refresh time	oracle
Oracle: OALL8 is in an inconsistent state	oracle
Oracle SQL technique to avoid filling trans log	oracle
How can I set the application information on a session using the Oracle thin JDBC driver?	oracle
Data Logging with Oracle (or any RDBMS)	oracle
How can I combine multiple rows into a comma-delimited list in Oracle?	oracle
Simulated OLAP	oracle
How to choose and optimize oracle indexes ?	oracle
Genealogy Query in Oracle	oracle
What is the dual table in Oracle?	oracle
How do I format my oracle queries so the columns don't wrap?	oracle
Does Oracle have an equivalent of MSSQL's table variables?	oracle
ORA-12514 after rebooting server	oracle
plsql custom numeric format	oracle
Oracle APEX access	oracle
Oracle: Global namespace qualifier for function?	oracle
Oracle Minus - From a list of values, how do I count ONLY non reversed values.	oracle
Is there a way to make Oracle recalculate a query plan for each query invocation?	oracle
scalar subquery in if statement Condition in PL/SQL	oracle
Using PL/SQL how do you I get a file's contents in to a blob?	oracle
How do I find the high water mark (for sessions) on Oracle 9i	oracle
What is sql Loader...in details	oracle
In Oracle Spatial (SDO), is there a way to get the centroid point of a polygon that is contained by the surface of the polygon?	oracle
Oracle 'printf' equivalent	oracle
Do DDL statements always give you an implicit commit, or can you get an implicit rollback?	oracle
Why would an Oracle synonym return a different number of rows to the underlying table?	oracle
Oracle 11g SQL to get unique values in one column of a multi-column query	oracle
Mapping an Oracle Date to a Java object using Hibernate	oracle
Determining Oracle Database Instance	oracle
Oracle Transactions	oracle
Is direct-path insert a good way to do bulk inserts in Oracle?	oracle
Is it stupid to write a large batch processing program entirely in PL/SQL?	oracle
Why does running this query with EXECUTE IMMEDIATE cause it to fail?	oracle
Oracle Datadiff	oracle
Oracle NUMBER Comparisons	oracle
How to performance tune when you have heavy concurrency on an Oracle table	oracle
show running processes in Oracle DB	oracle
Optional Entity Attributes	oracle
Explain Plan Cost vs Execution Time	oracle
Oracle PL/SQL Query Order By issue	oracle
Develop on local Oracle instance	oracle
How do I display the full content of LOB column in Oracle SQL*Plus?	oracle
How do you obtain the maximum possible date in Oracle?	oracle
how will you take only stored procedure backup in oralce 10g?	oracle
Run Oracle update statements in a batch mode	oracle
Oracle TO_DATE headache	oracle
Oracle Materialized Views Vs Replication on the same DB server	oracle
Oracle datafiles on a Network Share	oracle
How to install system packages into oracle?	oracle
How can I define a type in oracle11g that references a collection of that type?	oracle
Does oracle allow the uncommited read option?	oracle
How would you migrate hundreds of MS Access databases to a central service?	oracle
How can I optimize a dynamic search query in Oracle	oracle
Evaluate Oracle Expression	oracle
Oracle triggers error are not captured while using ADODB	oracle
Is there an good alternative to SQL*PLUSfor Oracle?	oracle
UNDOTBS Tablespace is Full what now?	oracle
How to use Oracle jdbc driver fixedString property?	oracle
[Probably something stupid] Can't create trigger using SQLPlus in Oracle	oracle
Use Oracle 6 from ASP.NET application	oracle
Oracle extractValue failing when query returns many rows	oracle
Oracle Query Optimization	oracle
How to define persistent variable in SQL*PLUS	oracle
What is the PL/SQL API difference between Oracle Express Edition (XE) and Standard Edition (SE)?	oracle
Oracle compile view sql	oracle
How can I estimate the size of an Oracle index?	oracle
Looking for good tool to convert Oracle - sql server	oracle
Function or Procedure for an IN clause	oracle
Is there integer ranges for Where Clause?	oracle
Oracle - select AND delete in a procedure	oracle
How come sqlplus not connecting?	oracle
How to retrieve XML into Oracle PL/SQL via an HTTP Post transaction?	oracle
No results from Oracle query in VB ASPX	oracle
Create or replace role?	oracle
Resultset logic when selecting tables without a join?	oracle
Return a value from a insert statement.	oracle
Returning Oracle ref cursor and appending multiple results	oracle
unwanted leading blank space on oracle number format	oracle
Duplicate Oracle DES encrypting in Java	oracle
Oracle: how to add minutes to a timestamp?	oracle
What are the advantages/disadvantages of using Oracle Auto Segment Space Management?	oracle
Oracle: how to use updateXML to update multiple nodes in a document?	oracle
What is the best column for storing XML in an Oracle database?	oracle
Accessing a Function over Database Link with Different Charsets in Oracle	oracle
Oracle: What exactly do quotation marks around the table name do?	oracle
update a field based on subtotal from another table	oracle
Oracle Floats vs Number	oracle
Oracle why does creating trigger fail when there is a field called timestamp?	oracle
How to determine if a table has been accessed in the last month?	oracle
Oracle: Using subqueary in a trigger	oracle
Oracle setting per user default scheme (not altering a session)	oracle
JDBC connection to Oracle Clustered	oracle
Best way to handle LOBs in Oracle dblink'ed tables	oracle
"hibernate: how to setup on-delete=""cascade"" in one-to-one relation"	hibernate
Hibernate: How to remove an entity to which noone refers to in ManyToOne?	hibernate
How to use Hibernate @Any-related annotataions?	hibernate
A Maven2 mojo that uses Hibernate: how to control logging?	hibernate
How can you remove a Criterion from a criteria?	hibernate
How can hibernate access a private field ?	hibernate
indexing data in Hibernate Search	hibernate
JPA/Hibernate: Can I have a Parent without annotations and a Child with	hibernate
Hibernate: update to sum from other table	hibernate
How to fetch hibernate query result as associative array of list or hashmap	hibernate
Hibernate Search querying ?	hibernate
Hibernate Auto Increment ID	hibernate
Hibernate and order by using column values	hibernate
understanding JasperReports and JRBeanCollectionDataSource...	hibernate
print query string in hibernate with parameter values	hibernate
Table called group, hibernate, DB2 and HSQL	hibernate
Oracle Deadlock when Hibernate application loading data for readonly use	hibernate
Hibernate named query parameter	hibernate
problem with basic attributes java.sql.Blob	hibernate
Changing target table for Hibernate mapping	hibernate
cascade on many-to-one association in hibernate	hibernate
Hibernate: Specifying columns in a one-to-many relationship	hibernate
Using an enum as a mapkey results in a RAW in the database	hibernate
How to sort through an association table in hibernate?	hibernate
When does retrieving a Hibernate proxy's id initialize the proxy?	hibernate
Hibernate logging with log4j	hibernate
Hibernate Inheritance Strategy and Why	hibernate
Hibernate database connection configuration	hibernate
Is it possible to have foreign key enforced without object-to-object mapping	hibernate
Hibernate annotation for postgresql SERIAL type	hibernate
Hibernate: Event Listener or Interceptor, what are the pros/cons in practice?	hibernate
Hibernate one to many using something other than a primary key	hibernate
JasperReports JRBeanCollectionDataSource still confused...	hibernate
delete hibernate entity without (attempting to) delete association table (view) entry	hibernate
Using hibernate criteria, is there a way to escape special characters?	hibernate
Hibernate property based on sum	hibernate
"Hibernate <generator class="""" > When is it best to use what?"	hibernate
Hibernate updating database sctructure with new indexes	hibernate
hibernate.hbm2ddl.auto how does Hibernate decide when to create or update the ddl?	hibernate
Hibernate and Flyweight	hibernate
Hibernate vs CFQuery	hibernate
Hibernate Criteria and multiple join	hibernate
hibernate mapping class	hibernate
Hibernate Annotations generating query that produces SQLGrammarException	hibernate
how to simple add an object to a collection in hibernate from client	hibernate
"How to insert an ""Optimizer hint"" to Hibernate criteria api query"	hibernate
UserType join in Hibernate	hibernate
Hibernate QueryException couldn't resolve property	hibernate
How to Configure Hibernate with Eclipse galilio	hibernate
Recording test data in Hibernate	hibernate
Equinox (OSGi) and JPA/Hibernate - Finding Entities	hibernate
With Hibernate, an Interceptor receives the same collection object as current and previous, how do I get real current and previous values?	hibernate
"How to achieve ""not in"" by using Restrictions and criteria in Hibernate?"	hibernate
InvalidMappingException  Hibernate mapping file...anybody can you give resolution	hibernate
Audit Schema Mapping with Hibernate	hibernate
Workarounds for unresolved hibernate bug when embedded collections contain collections?	hibernate
"Treat '0',""-1"" as Null"	hibernate
Hibernate Query with conditions in a complex db structure	hibernate
Problem using @SecondaryTable in Hiberante	hibernate
Spring user transaction with hibernate	hibernate
Hibernate query not returning full object	hibernate
how to map a one-to-many collection to a joined subclass when key is in the parent class	hibernate
Hibernate One-To-Many Unidirectional on an existing DB	hibernate
Retrieving and loading third level refferenced classes through HQL	hibernate
Hibernate multi user environment	hibernate
Hibernate Subclass which has multiple discriminator values	hibernate
Hibernate Criteria - Exclude records with same id but different attribute values	hibernate
Hibernate Query Hints for JPA	hibernate
How do we count rows using Hibernate?	hibernate
How to use the Hibernate optimistic locking version property on the front end?	hibernate
Hibernate: ID generator using increment and Oracle Schema	hibernate
Hibernate -using Table per subclass - how to link an existing superclass object to a sibclass object	hibernate
EntityManager.merge inserts duplicate entities	hibernate
Hibernate many-to-many association with the same entity	hibernate
How to avoid hardcoded field names in HQL, Hibernate?	hibernate
Hibernate - how to map an EnumSet	hibernate
Hibernate HQL: how to use a complex left join fetch	hibernate
How can I set the schema name used by hibernate entities at query time?	hibernate
Hibernate: load a field from a query , but don't insert it to the table	hibernate
Optimizing an ORM-based model post-launch	hibernate
Hibernate Inheritance Mapping and Attribute Override	hibernate
Hibernate criteria query on different properties of different objects	hibernate
Disable Hibernate auto update on flush on read only synonyms	hibernate
Custom joins entitys on Hibernate	hibernate
How do I persist a Java property of type Object using Hibernate?	hibernate
hibernate SELECT..WHERE.. IN (value1, val2...)	hibernate
hibernate composite Primary key contains a composite foreign key, how to map this..	hibernate
Is it possible to get the SQL alias of a join table for a Hibernate sqlRestriction?	hibernate
How do I map a hibernate Timestamp to a MySQL BIGINT?	hibernate
Grouping in hibernate - stupid question	hibernate
Can I make an embedded Hibernate entity non-nullable?	hibernate
Hibernate template close transaction	hibernate
Hibernate, GWT and Gilead: sessions, transactions and caches	hibernate
Hibernate question	hibernate
Storage of auditable fields per entity	hibernate
hibernate.properties classpath conflict	hibernate
Hibernate mapping for situation, where the the key is also used as many-to-one parameter	hibernate
Hibernate with Oracle JDBC issue	hibernate
Can Hibernate return a collection of result objects OTHER than a List?	hibernate
How to force Hibernate 3.3 or 3.5 to use CGLib instead of Javassist?	hibernate
Mapping to varchar and nvarchar in hibernate	hibernate
Hibernate HQL query by using like operator	hibernate
Comparing entities while unit testing with Hibernate	hibernate
Mix HQL and SQL in the same query	hibernate
Spring-Hibernate DAO naming convention?	hibernate
How to implement this Query in Hibernate?	hibernate
How to make query on a property from a joined table in Hibernate using Criteria	hibernate
Using Different Hibernate User Types in Different Situations	hibernate
(N)Hibernate: core/master mappings with relationships	hibernate
Using entity id as a reference in Hibernate	hibernate
Hibernate implicit entity restrictions	hibernate
Many-to-many on the same table with additional columns	hibernate
Hibernate returns invalida results with composite key.	hibernate
Get Hibernate transaction status	hibernate
How to update a database schema without losing your data with Hibernate?	hibernate
How to validate Hibernate mapping against database	hibernate
Criteria query with restriction across a joined subclass problem	hibernate
Add new Entity to persisted Collection	hibernate
Hibernate Error : Caused by: org.hibernate.NonUniqueObjectException: a different object with the same identifier value was already associated with the session:	hibernate
Custom EntityNotFoundDelegate	hibernate
Unreliable Hibernate Objects	hibernate
How can I use a .hbm.xml file as input in hbmtemplate for Maven?	hibernate
hibernate one-to-one or component?	hibernate
Save more than object with the same identifier into a database in the same session????????	hibernate
unit of work in a java 'main' application	hibernate
Hibernate transaction problem	hibernate
(Lazy) LEFT OUTER JOIN using the Hibernate Criteria API	hibernate
MyEclipse HIBERNATE Does NOT Order Property Sets by ID?	hibernate
Hibernate: Query entities which contain a specified element in a CollectionOfElements?	hibernate
Hibernate-validator: @NotEmpty does not work for null values	hibernate
hibernate, mysql, glassfish v3, and JTA datasource	hibernate
Session management using Hibernate in a Swing application	hibernate
Hibernate case-insensitive utf-8/unicode collation that works on multiple DBMS	hibernate
Why do we use hibernate annotation?	hibernate
Update father on interceptor	hibernate
Creating Object from Hibernate Mapping	hibernate
Hibernate @Version Field error	hibernate
@OneToOne getting returned as ManyToOneType	hibernate
Hibernate many-to-many mapping and cascade=delete	hibernate
Hibernate + Annotations + Validator: Length constraint inside EmbeddedId ignored by hbm2ddl	hibernate
How to get a distinct result, but return another column in the select?	hibernate
On-demand eager loading	hibernate
Hibernate @OneToMany - mapping to multiple join tables	hibernate
Hibernate: Identifier	hibernate
Why is hibernate open session in view considered a bad practice?	hibernate
NullPointerException on merge()	hibernate
count(*)  in hibernate criteria ?	hibernate
How to create and read a sequence in Hibernate?	hibernate
Hibernate lazy loading + Jersey REST = eager loading?	hibernate
How to do ORM for this situation?	hibernate
Cocoa binding to a particular item in an array controller	cocoa
NS(Array|Tree)Controller Architecture for multiple NSViewControllers	cocoa
Open string in app per drag'n'drop on icon	cocoa
How did the Cocoa Framework got its name?	cocoa
Cocoa NSDocument: getting autosave to work	cocoa
NSEnumerator performance vs for loop in Cocoa	cocoa
How do I add a third party Framework to xcode project?	cocoa
Cocoa Document-based app	cocoa
Creating object named after the value of an NSString - is it possible?	cocoa
Global object for Javascript to interact with Safari plug-in	cocoa
Determine if NSNumber is NaN	cocoa
Detecting when an NSView is dealloc'ed	cocoa
What are the ways to convert/encode to AAC in Cocoa?	cocoa
Question about extensiblity of Cocoa Touch Controls	cocoa
Idiomatic, classy, open-source examples of Cocoa Interfaces?	cocoa
Do I still need to learn about managing memory now that Objective-C/Cocoa has Garbage collection?	cocoa
Problems with the PHP script to generate the licenses in Aquatic Prime	cocoa
Does a newly produced mac application need to support 10.4, and can I both support 10.4 and prepare for 64bit?	cocoa
How can I resize an NSTextField to fit the text that it holds?	cocoa
How do you test an asynchronous method?	cocoa
CFStringRef to NSString	cocoa
how to new a nib file in xcode 3.0?	cocoa
What is a referencing outlet?	cocoa
Get rid of NewApplication in a dynamic way?	cocoa
What's the best way to validate a user-entered URL in a Cocoa application?	cocoa
Why am I getting this error, when it cannot be true?	cocoa
Initialize NSMutableArray: [NSMutableArray array];	cocoa
Setting the NSBrowserCell image using bindings?	cocoa
Changing font tracking in Cocoa	cocoa
give perspective to UIImageView	cocoa
How to escape double quotes in string?	cocoa
Profiling Objective-C binary image size	cocoa
What data type do I use for an integer in SOAP XML in Cocoa?	cocoa
How do you give a text field a default font and some padding?	cocoa
Kill process after launching with AuthorizationExecuteWithPrivileges	cocoa
NSFileHandle readInBackgroundAndNotify does not work	cocoa
How do you check for sanity in objective-c and cocoa?	cocoa
Is there  a way to get coordinates relative to the innermost NSView when the parent is not the window?	cocoa
What's the best way to add a composite property for binding to an existing class	cocoa
Drawing on desktop in Mac OS X	cocoa
SIGPIPE Exception	cocoa
Weird bindings issue	cocoa
how to open a panel with new folder function by NSOpenPanel ?	cocoa
Making a NSPopUpButton display all my iCal Calandars.	cocoa
Cannot pass message (or Call a function) using the outlet of a customized class	cocoa
Cross Platform Development - Go with a Cross Platform UI Toolkit or Native on Multiple Platforms?	cocoa
Easy way to get size of folder (ObjC/Cocoa) ?	cocoa
Who owns an NSWindowController, in standard practice?	cocoa
Capturing all multitouch trackpad input in Cocoa	cocoa
Display os x window full screen on secondary monitor using Cocoa	cocoa
Need help with NSMutableData.	cocoa
Modal custom sheet not closing	cocoa
Cross-user and cross-process shared settings	cocoa
How do you get search capability similar to Spotlight or iTunes?	cocoa
taglib.framework for cocoa	cocoa
how to click a text with underline for showing a web?	cocoa
How would you make a Status Item show or Hide a window when clicked?	cocoa
round NSDate to the nearest 5 minutes	cocoa
How can I slide a view in and out of a window in a Cocoa program.	cocoa
[NSView setFrame:] not working?	cocoa
Carbon development on intel based mac	cocoa
Use NSArrayController with nested NSMutableArrays (Cocoa Bindings Question)	cocoa
Create a colored bubble/circle programmatically	cocoa
Duplicate records in Core Data on fetch	cocoa
Threadsafe UITableView	cocoa
Cocoa screen capturing?	cocoa
WHy can't I correctly parse this date string with NSDateFormatter?	cocoa
How do you put a normal control into an NSView?	cocoa
Limit a double to two decimal places	cocoa
Check whether application already running	cocoa
Display hidden characters in NSTextView	cocoa
Making an NSAlert be displayed when the User attempts to delete a row from an NSOutlineView when it has children.	cocoa
How to use NSString drawInRect to centre text?	cocoa
Adding Padding To The 'left' of a Text Field.	cocoa
How to do an http get in cocoa on the iPhone	cocoa
Sync Services Client and Schema Xcode Project Structure	cocoa
How to display a raw YUV frame in a Cocoa OpenGL program	cocoa
Open a terminal window to a specified folder from a Cocoa app.	cocoa
OS X - App doesn't show up in force quit.  How do I fix that?	cocoa
How do I override NSError presentation when bindings is involved?	cocoa
How hard is it to get a cocoa application to run on windows?	cocoa
Error handling in Core Data	cocoa
Navigation Controller strategy with an Address Book picker	cocoa
Cocoa webView - Disable all interaction	cocoa
Error Code Reference for OSX/Cocoa	cocoa
Subclassing NSOutlineView	cocoa
Which delegate method I should use to respond to clicks on a text field?	cocoa
Notification of WebView's selection change	cocoa
App crashes when updating an highlighted NSMenuItem	cocoa
Keep a reference to a file after it has moved in objective-c?	cocoa
In cocoa, how can I darken everything displayed in a single NSView?	cocoa
Singleton Design	cocoa
Creating CGImageContext for resizing UIImage fails in simulator	cocoa
Handling very large SFTP uploads - Cocoa	cocoa
Create drag-drop graphic when installing OS X application from dmg	cocoa
storing modified image in iphone.	cocoa
How can I safely write to a given file path in Cocoa, adding a numeric suffix if necessary?	cocoa
NSStatusItem to be always left?	cocoa
NSTableView sort not getting correct ID	cocoa
JavaScript developer looking for insperation from frameworks such as cocoa	cocoa
"Programmatic equivalent of ""Visible at Launch"" for NSWindows"	cocoa
Simple string parsing in Cocoa / Objective-C: parsing a command line into command and arguments.	cocoa
Is there an easy way of sorting a plist (array of dictionaries) by key value?	cocoa
Altering the style of an NSSearchField.	cocoa
How would you make a text cell in a an Outline View show how many children the parent row has?	cocoa
How can I use Cocoa's Accessibility API to detect that a window is brought to front?	cocoa
How to scale a UIImageView proportionally ?	cocoa
Why is App window only opening once and then not opening again?	cocoa
What is the best way to solve an Objective-C namepsace collision?	cocoa
NSTableView - NSButtonCell Data Source type?	cocoa
Is it possible to replace the Mac login screen?	cocoa
[super viewDidLoad] convention	cocoa
Why do all the Checkbox's in my Outline View check when only one is clicked?	cocoa
UserDefaults in system preference pane installed for multiple users in OSX...	cocoa
What is the best way to implement syntax highlighting of source code in Cocoa?	cocoa
Odd problem using addObserver:forKeypath:options:context: in init method	cocoa
NSNumberFormatter: plusSign vs. positivePrefix	cocoa
Is parentViewController always a Navigation controller?	cocoa
Logging all cocoa events?	cocoa
How can I force invalidation of a Cocoa program without additional custom code?	cocoa
how to get the filepath when drag it from finder to a webview?	cocoa
How to Animate scrollpoint?	cocoa
Which implementation of Markdown for a Cocoa application?	cocoa
Making A Menu Item Display A Window.	cocoa
Handling exceptions raised during method called via NSObject's performSelectorOnMainThread:withObject:waitUntilDone:	cocoa
How do you make a Text Label display how many rows there are in the table.	cocoa
Making the Children Rows in an Outline View be deleted when their parent is.	cocoa
Adding to a Tree Controller from an NSArray.	cocoa
"Should ""to-many"" relationships be modelled as properties?"	cocoa
Highlight colors in an NSTableColumn on highlight	cocoa
How can I make an NSOutlineView where some of the entires are buttons?	cocoa
NSBorderlessWindowMask Window wont show NSPanels if not front most window	cocoa
How do I use an NSFormatter subclass with an NSPopUpButton	cocoa
"What describes the ""File's Owner"" best in objective-c / coca Nib?"	cocoa
Temporary text attributes causing massive slowdown	cocoa
Reference from UITableViewCell to parent UITableView?	cocoa
How do you add context senstive menu to NSOutlineView (ie right click menu)	cocoa
Why does my nib's window close immediately?	cocoa
Cocoa Bad Habits	cocoa
NSPredicateEditor and relationships	cocoa
"NSTextField with ""padding"" on the right"	cocoa
how to get the System version?	cocoa
NSLog on Mac OSX/iPhone, usage of the '#' key?	cocoa
Why does -[NSTextStorage replaceCharactersInRange: withAttributedString:] sometimes, sometimes not honor fonts in other character sets?	cocoa
Countdown Timer in Cocoa	cocoa
File Watcher in Cocoa	cocoa
Escaped unicode to unicode character in Cocoa	cocoa
Binding NSSlider to control the zoom of an IKImageBrowserView	cocoa
Copy Protection (mac apps): most cost effective solution??	cocoa
The easiest way to write NSData to a file	cocoa
"CoreLocation for OS X using iFrame Google Maps can't select ""Map, Satellite, Terrain"" as default"	osx
How to create drag and drop DMG file, Mac installer	osx
OSX Application Bundle Working Directory	osx
Reloving AliasRecord with relative path on a new volume	osx
How to create installer for Mac Operating system for my java application	osx
cvs for Mac OSX	osx
Embed webserver in carbon bundle	osx
How to make a hard to kill process in Mac/Linux?	osx
Version Control for a collaborative website on Mac	osx
Where is PyGTK for Mac OS X?	osx
os x: sending mail to localhost	osx
How to use ditto on OS X to work like cp -a on Linux	osx
Creating an OS X Service	osx
Obtain a CGContextRef of NSView outside of drawRect ?	osx
Mac Plugins no longer support GetWindowFromPort?	osx
NMBLookup OS X returning inconsistant results	osx
How to compile for Mac OS X 10.5	osx
"Creating a ""Uninstaller"" for a program on Mac OS."	osx
Mac/Windows Switching	osx
Proper way to make a fat binary prefer to be 32bit on 64bit OS X 10.6?	osx
Does anyone use BetterAuthorizationSample?	osx
How to run a script on device mount in OSX.	osx
C program stuck on uninterruptible wait while performing disk I/O on Mac OS X Snow Leopard	osx
Battery status in OSX?	osx
NSMutableDictionary removeObjectForKey throwing EXC_BAD_ACCESS for a var that isn't released...	osx
What is CHUD Remover? (Came with Xcode on OS X)	osx
Ruby interpreter won't run on my Mac	osx
"""Click to execute"" in Mac OS X"	osx
backporting NSWindowDelegates windowDidEndLiveResize behaviour in OSX 10.5?	osx
Mac: Setting up SVN for personal development	osx
How to Suppress the keychain prompt when the app modified?	osx
Mac OSX 10.6 compiler: a puzzling experience with 32 vs 64 bit.	osx
How does one relaunch Finder programmatically?	osx
What's the best way to find out the installed version of the iPhone SDK?	osx
Installing Boost libraries on Snow Leopard	osx
open firmware console on mac osX (intel)	osx
Get text field info out of loaded webpage - Mac OS X Development	osx
Record speaker output with Audio Unit	osx
What is the syntax for custom stacks for the OSX Leopard dock?	osx
Time Machine API / Command-line scripts ?	osx
How can I get dev tools (such as make) for Mac OS X via the command line	osx
How can I change the default edtior for OS X on install?	osx
"NSSavePanel: Squelching the ""confirm replace?"" dialog"	osx
Running other java versions on OSX	osx
Equivalent of GetCursorPos() in Mac's Carbon	osx
How to write OSX finder new functionality/view	osx
Running Visual Studio in Parallels for mac - problem with debugging sites lying in os x	osx
How do I use stackshot to debug my application?	osx
Setting a charset symbol in dylib	osx
What is the keyword for Mac OS X Service-like applications?	osx
How to build a dmg Mac OS X file (on a non-Mac platform)?	osx
Sporadic errSecAuthFailed (-25293) when accessing KeyChain with SecKeychainFindGenericPassword?	osx
make mac package/bundle programmatically.	osx
Awaking Mac programatically	osx
How do I log to file on the Mac (similar to log4net)	osx
sem_init on OS X	osx
Accessing iSight programatically?	osx
Why use SysV or POSIX shared memory vs mmap()?	osx
Eclipse CDT on Snow Leopard cannot find binaries	osx
OS X Widget Scroll Issue	osx
Do you use the original (German) apple keyboard/keyboard layout when programming on mac?	osx
Moving Mac's user settings to another users	osx
Parse DS_Store w/ PHP	osx
Mac Priting : programatically can not set printQuality, mediaType, paperSource, outputBin	osx
Obj-C object instance not recognized?	osx
Install macruby to specific directory?	osx
Why should I have a version control system if I use time machine?	osx
Cocoa Application Help	osx
Getting the name of document that used to launch the application bundle on OS X	osx
Windows to Mac transformation	osx
OS X bash: dirname	osx
x84_64 compatibility with 10.5.8	osx
When was <input type=search> introduced in Safari	osx
How do I record timetamps in a MacOSX C++ program?	osx
What applescript will a particular application accept?	osx
How to Open Terminal Window Automatically on Mac OS X	osx
Determine if a directory is a bundle or package in the Mac OS X terminal?	osx
how does the osx finder recognize a png file?	osx
Programmatically add an alias to the Dock in OS X	osx
Mac Terminal.app annoying bug - How to fix it?	osx
macports confusion	osx
Trouble installing Maatkit on Mac OS X	osx
Programming in Lua for the Mac?	osx
What's a good book for learning Cocoa and Mac programming?	osx
How to avoid installing unnecessary dependencies with MacPorts?	osx
How to read the background color of a cell through a (ruby) script from Microsoft Excel on Mac Osx?	osx
Accessing I/O Catalog Class Objects	osx
What makes it possible to drag-open files on a Mac?	osx
Unable to diff dot-files in Mac's FileMerge	osx
Sample a process on Mac OS X from a C/C++ program	osx
What is the correct directory layout for a web server under Mac OS X?	osx
Problem in running Junit tests in eclipse 3.4.1 on Mac OS	osx
Equivalent of user32.dll on OS X	osx
Leopard Terminal (and iTerm) Ignores Control Key Combos	osx
How do you create a Keynote-like interface in Cocoa and IB?	osx
Command key as Meta key in OS X Terminal.app	osx
What is the correct way to set ANT_OPS in OS X?	osx
Whatâ€™s a good way to deal with a german keyboard when using Emacs on Mac OS X?	osx
Errors installing some gems on Snow Leopard - libxml2	osx
Unknonwn Format: JPG - ruby on rails-  OS X	osx
"Using an external ""windows""-keyboard under Mac OS X"	osx
RDC sessions to Win 7 terminate on CTR and arrow keys	osx
Using AppleScript to hide Keynote Text Fields in A Slide	osx
How to add text to disk image?	osx
Can't copy or paste text in Cocoa after deleted edit menu item	osx
Finding usb drive paths in Mac OS 10.4	osx
How to discover number of cores on Mac OS X?	osx
Install PDO on OS X Leopard	osx
How can I tell if Voice Over is turned on in System Preferences?	osx
Loading my private key for use in git on Mac	osx
What is a good C++ editor for Mac OS X?	osx
Meta and # in a UK mac terminal	osx
Mac Dev - How to refresh view for 2d game?	osx
What does the console error 'Unable to clear quarantine' mean?	osx
How to dump out an array of of pixels as a png?	osx
Mac : I want the file open dialog in an app like Xcode to open in the last-visited folder ...	osx
Programmatically stream audio in Cocoa on the Mac	osx
Binding to Media keys on Apple keyboards under OSX 10.5	osx
Should you register new extensions with Apple?	osx
How to force a page refresh while pressing the back button in MAC safari	osx
OS X: creating or extracting preview(.jpg,.png) of .eps file	osx
CoreAudio AudioUnitSetProperty always fails to set Sample Rate	osx
Epoch Time (Ticks since 1970) - Mac vs. Windows	osx
Flowchart app for OSX?	osx
endian-ness of new macs - are all pc platforms the same now?	osx
Compiling and using spl2c on Mac OS X 10.6	osx
llv8call on Mac OS X - 2nd try	osx
Resources to learn MacOSX development from Linux/Windows development point of view	osx
Creating a dual Mac/Win Autorun CD	osx
Not showing Dialog when opening file in Acrobat Pro using Applescript	osx
Free PHP editor for Mac?	osx
gprof reports no time accumulated	osx
Mac OS X - associate application with file type icon	osx
Building OSX App Bundle	osx
What happens to my app when my Mac goes to sleep?	osx
How to I distribute a Mac OS X with dependent libraries?	osx
Why doesn't OS X have the same flickering problems that Windows does?	osx
Developing for Mac OS X, on Windows?	osx
In Applescript, how can I get to the Help menu Search field, like Spotlight?	osx
"How do I get the ""Measurement Units"" setting from OS X?"	osx
What is the best tool for creating user guides with screenshots on MAC?	osx
How to find the other point of a Unix domain socket on Mac OS X to write/read it?	osx
Mac OS X/Bluetooth: Programmatically disable simple pairing?	osx
How do I take a screengrab of a single window using Cocoa or Carbon on OS X?	osx
How to replace old ParamText/StandartAlert with newer CFString replacements?	osx
IKImageView and scroll bars	osx
How to get cpu temperature and fan speed on osx?	osx
Extract from Cache.db files on Mac OS X Leopard	osx
Looking for an OSX application that can do image processing using a webcam.	osx
Lua compiled scripts on Mac OS X - Intel vs PPC	osx
Event Receiver for Document Library	sharepoint
How to access the uiserID of the user who initiated a workflow	sharepoint
SharePoint web services: test if file exists	sharepoint
Are SharePoint site templates really less performant than site definitions?	sharepoint
What steps do you take to increase performance of a Sharepoint site?	sharepoint
Custom SharePoint List View - can I put it in a feature (WSP)?	sharepoint
Does anybody know if manisfest.xml (wsp) has an intellesense for Visual Studio?	sharepoint
SharePoint DelegateControl Render Order	sharepoint
Retrieving the associated shared service provider's name?	sharepoint
Upgrading from SPS 2003 to MOSS 2007	sharepoint
Microsoft Sharepoint	sharepoint
Include value of sharepoint's version column in a word document	sharepoint
SharePoint and workflows	sharepoint
MOSS 2007 Server hanging problem - AppDomainUnloadListener.RegisterSelf() & PublishingHttpModule.Init()	sharepoint
SharePoint - ASP.Net Controls Integration	sharepoint
I want to create a form in share point that allows the booking of time on a timetable	sharepoint
Sync SharePoint Sets with File System?	sharepoint
Create Multiple 'Posts' lists in one SharePoint Web.	sharepoint
Best Pattern for AllowUnsafeUpdates	sharepoint
MOSS SpNavigationNode.Children always empty	sharepoint
How to display line breaks in SharePoint comment history field	sharepoint
SharePoint 2007 Publishing site with deep menu structure	sharepoint
SharePoint Development / Production Environments	sharepoint
Developing for Sharepoint 2003 using Visual Studio 2008?	sharepoint
Sharepoint Search Property Weighting	sharepoint
Is is possible to populate a SharePoint list from an Excel sheet?	sharepoint
Random errors while downloading files from sharepoint	sharepoint
mailto link sharepoint desgner	sharepoint
Setting a publish page content programatically	sharepoint
SharePoint 2007 -Content for this URL is excluded by the server because a no-index attribute	sharepoint
SOAP web service running on SharePoint	sharepoint
What knowledge should a software architect have about SharePoint?	sharepoint
Sharepoint, Create View, Filter Properties	sharepoint
Moving SharePoint (MOSS 2007) Sites	sharepoint
SharePoint List Pre-Population	sharepoint
SharePoint problem using a Feature with AllUsersWebPart node	sharepoint
Debugging SharePoint 2007 Code	sharepoint
How to edit default.aspx on SharePoint site without SharePoint Designer	sharepoint
display fieldname and value of sharepoint list	sharepoint
ERROR: request not found in the TrackedRequests. We might be creating and closing webs on different threads.	sharepoint
Hiding a SharePoint Custom Field Type in Edit and Create mode	sharepoint
Is Sharepoin Server mandatory for Excel Services or Excel Web Access	sharepoint
Intermittent Problems loading type	sharepoint
Can a STP template be hidden from subsite creation page?	sharepoint
Adjust Sharepoint URL field length	sharepoint
Packaging multiple features into a single WSP solution file	sharepoint
sharepoint - add custom column to list via object model	sharepoint
Where can  I change the HTMl template for a Sharepoint notification?	sharepoint
Is it possible to add Web Parts to the My Profile page of My Site?	sharepoint
How to Publish a SharePoint site on the internet	sharepoint
SharePoint searching external database	sharepoint
Sharepoint: Image field with a link	sharepoint
How to open a link from one web app to another already authenticated?	sharepoint
Web Part Feature and Reading XML File	sharepoint
SharePoint: How to determine a site's site directory	sharepoint
Document is not updated after check in form Word	sharepoint
"How to modify ""Summary View"" in SharePoint list web part?"	sharepoint
SharePoint - Custom Dataview - Link Rendering Issues	sharepoint
Best way to migrate site content into a new SharePoint site	sharepoint
Creating a sub site in SharePoint takes a very long time	sharepoint
SharePoint exception documentation	sharepoint
Capturing title change event on SPWeb	sharepoint
SharePoint - Site.RootWeb.AllUsers not returning all users	sharepoint
Sharepoint - Fields appears twice on View / New Item	sharepoint
Share a .NET Membership Database with SharePoint?	sharepoint
Controlling how custom field types are rendered when exported to spreadsheet	sharepoint
allowing anonymous user to save contents of a form in sharepoint doc library	sharepoint
Update Files in Sharepoint Document Library	sharepoint
Test deployment for Sharepoint by multiple developers on a single server	sharepoint
stopping sharepoint workflow programatically	sharepoint
what would I have to do to get the new HTML Editor ajax control to work as a sharepoint content editor webpart?	sharepoint
Customize the Sharepoint add list column page	sharepoint
"Why would clicking ""View All Site Content"" generate an error?"	sharepoint
What are some decent ways to prevent users from creating meeting workspaces?	sharepoint
"Moss 2007 SSP Error ""Search application '{0}' is not ready."""	sharepoint
SharePoint user's AD group membership	sharepoint
Accessing List Images	sharepoint
Creating a custom EditorPart in SharePoint	sharepoint
How should I use this SetSPN command when installing SharePoint	sharepoint
How does SharePoint Services 3.0 Search work ?	sharepoint
Sharepoint Calculated column in list	sharepoint
SharePoint (MOSS 2007) remove user	sharepoint
Has anyone successfully re-created the ECB menu on the Data Form web part?	sharepoint
SharePoint Approval Workflow	sharepoint
Order documents by most popular in sharepoint content query webpart	sharepoint
WSS 3.0 Multiple Domains	sharepoint
Accessing SPWorkflowStatus from an SPListItem	sharepoint
Global Customized View for Document Libraries in Sharepoint	sharepoint
What are the Valid values of the searchboxex AppQueryTerms enum?	sharepoint
Doing Forms With Just Windows SharePoint Services 3.0?	sharepoint
How do you create a new site template for my sites?	sharepoint
Changing SharePoint Site Collection Title	sharepoint
Sharepoint: How to programmatically manage SPFolder and SPListItem permissions	sharepoint
"SharePoint Site Design & Implementation: ""Online Manual"""	sharepoint
Do organizations ever use SharePoint on a port other than 80?	sharepoint
sharepoint permition on apple computers	sharepoint
SPWorkflowTaskProperties.ExtendedProperties arenâ€™t populating the fields in my task	sharepoint
ListTemplateOwner	sharepoint
"Only allow one entry per User in a List - ListReceiver ""Feature"" for a List?"	sharepoint
Change the default list aspx pages in SharePoint	sharepoint
SharePoint 2007 - Get Central Admin URL ID (guid)	sharepoint
where should I store CSS files in a sharepoint install?	sharepoint
Sharepoint direcory list	sharepoint
Sharepoint: How to find out whether an realtive URL is available or already used by a site	sharepoint
SharePoint (MOSS) hosting with custom code allowed	sharepoint
Errors creating WebPart subclass in another assembly	sharepoint
Customized Sharepoint List Add/Edit page is slow to load	sharepoint
How to move documents and list items in Windows SharePoint Services?	sharepoint
How to create a shared document library in SharePoint that can be used in subsites?	sharepoint
How do I access the data passed back from a workflow association form?	sharepoint
Using fields from a 'lookup-ed' sharepoint list	sharepoint
"How to display a SharePoint friendly ""Access Denied"" message"	sharepoint
Including Sharepoint /pages/ in Import/Export	sharepoint
PortalSiteMapProvider causing excessive SPRequest objects	sharepoint
How can I automatically enable content approval on a SharePoint list?	sharepoint
Transactional Design Pattern	sharepoint
SharePoint 2007 Publishing site developtment and deployment	sharepoint
SharePoint 2007 - SQL Query to find a list of documents in site collection	sharepoint
Sharepoint User Favorite Documents	sharepoint
Moving sharepoint installation to a different port / URL	sharepoint
MOSS 2007 and Sql Server Reporting Services from dev to prod	sharepoint
Deployed Web Part not showing up in 'Web Part Gallery: New Web Parts'	sharepoint
test sending emails from SharePoint without smtp server	sharepoint
Anyone used CSS blueprint with Sharepoint sites	sharepoint
SharePoint Visual Studio document upload Web Test fails with Connot close stream until all bytes are written	sharepoint
Sharepoint Conditional fields in Edit.aspx	sharepoint
Drag and Drop files into a SharePoint webpart to upload into DocLibrary	sharepoint
MOSS 2007: BDC permisson problem - no BDC application is listed in the web part's configuration menu	sharepoint
Inconsistent display behavior for Quick Launch menu in MOSS 2007	sharepoint
SharePoint SPListItemCollection ReorderItems	sharepoint
Sharepoint stripping HTTP Headers	sharepoint
How do you instantiate a SPWeb Object from a console app?	sharepoint
How to get all WebpartZones on a page in Sharepoint 2007?	sharepoint
SharePoint 2007 Remote File Access Denied CAS	sharepoint
SharePoint - Get a list of current users	sharepoint
SharePoint Lists vs Database Tables performance...	sharepoint
Sharepoint Web Part Management	sharepoint
RSS viewer in SharePoint strange	sharepoint
Users not showing up in Sharepoint Audiences	sharepoint
Which SharePoint 2007 features are not available to Office 2003 users?	sharepoint
SharePoint: Get site directory's categories programmatically	sharepoint
SharePoint 2007: Formatting a FormField	sharepoint
Workflow Auto Cleanup timer job does not run	sharepoint
SharePoint WebPart Permissions	sharepoint
Querying list items and using SharePoint web services vs the object model	sharepoint
How to implement an IFilter for indexing heavyweight formats?	sharepoint
SPListItem in FormsLib does not handle blank values	sharepoint
Search Center on SharePoint Publishing site	sharepoint
Custom field type derived from SPFieldCalculated	sharepoint
Sharepoint as a high volume information system	sharepoint
Correctly over-loading a stringbuf to replace cout in a MATLAB mex file	matlab
matlab image processing 3d	matlab
Slow performance using anonymous functions in Matlab	matlab
How do I label two vectors in Matlab?	matlab
Matlab Simulink scope log or saved data	matlab
Simulink sim of rician channel ber process	matlab
Line of best fit scatter plot	matlab
Compiled Matlab: application hangs at the end	matlab
How to set output size in Matlab newff method	matlab
Combining Structures	matlab
"Matlab: ""grouping mean"""	matlab
Plotting data on time (date) axis in matlab	matlab
How to plot a nonlinear system of 3 equations with 3 symbolic variables in matlab?	matlab
Out of Memory Matlab Error	matlab
How to concatenate two strings in MATLAB?	matlab
problem related to stucture and non structure in matlab	matlab
How to call(execute) a function in a for loops in MATLAb	matlab
MATLAB: function makes 4 recursive calls. I have a 4-core processor. Can I parallelize?	matlab
How to format a matrix for saving	matlab
Sharing memory between processes [matlab]	matlab
MATLAB class array	matlab
MAtlab combining edge region back into image	matlab
matlab to draw ellipse and ellipsoid	matlab
Convert CRC check from Matlab to c#	matlab
Maximum expression string length in regexp (MATLAB)	matlab
Matlab multiplication of 2 vectors error	matlab
Drawing a polygon around groups of datapoints in MATLAB	matlab
how to divide an image in blocks in matlab	matlab
memory not freed in matlab?	matlab
Analyzing data for noisy arrays	matlab
MATLAB date selection popup calendar for gui	matlab
Nearest-neighbor interpolation and matlab	matlab
how can I find the parameters of matrix-equation in matlab?	matlab
Performance of swapping two elements in MatLab	matlab
How to clear persistent variables while keeping breakpoints in MATLAB?	matlab
How to find the most dense regions in an image	matlab
matlab in C C++ and  C C++ in matlab	matlab
How do I write a csv file from a txt file with line omittion	matlab
Matlab: convert function to simulink block	matlab
Get all pixel coordinates of a vector inside a image	matlab
Multi-Dimension any()	matlab
How to use aryule() in Matlab to extend a number series?	matlab
intersection of two line	matlab
"""Publish"" to pdf"	matlab
Mapping 2 vectors - help to vectorize	matlab
How to format data for use in nntool (MATLAB)?	matlab
System command usage in Matlab	matlab
Is there a way in Matlab using the psuedo number generator to generate numbers within a specific range?	matlab
Whay was writtem matlab in C instead of Fortran?	matlab
How to draw different surfaces with the same colormap in Matlab	matlab
Does Matlab handle USB communication?	matlab
Is it possible for a MATLAB script to behave differently depending on the OS it is being executed on?	matlab
MATLAB: Using ODE solvers?	matlab
Why is Matlab's inv slow and inaccurate ?	matlab
Constants in MATLAB	matlab
How to plot an Excel chart in a Matlab's figure	matlab
Matlab - divide matrix elements by column sums.	matlab
an axis is not showing up in Matlab	matlab
determine whether matlab license is server- or user-based	matlab
What is matlab good for? Why is it so used by universities? When is it better than python?	matlab
Modify an Excel sheet from Matlab	matlab
Houghlines in Matlab	matlab
filter that uses elements from two arrays at the same time	matlab
Best Matlab toolbox that implements Support Vector Regression?	matlab
Matlab Magical Mystery timing behavior	matlab
plot circle but show ellipse in matlab	matlab
read angles in radian and convert them in degrees/minutes/seconds	matlab
Trace an arrow toward a specific angle	matlab
java.lang.UnsatisfiedLinkError: Native Library {____.dll} already loaded in another classloader	matlab
Matlab Simulink: Transfer Function	matlab
Matlab engine VS libraries created by MATLAB Compiler	matlab
matlab Bucketing Algorithm Help	matlab
How to generate a unit vector pointing in a random direction with isotropic distribution of direction?	matlab
cell and array in Matlab	matlab
Rotation Matrix calculates by column not by row	matlab
Matlab command to access the last line of each file?	matlab
Porting matlab functions to scilab. How to use symbolic?	matlab
how to shear image in matlab without using built in function?	matlab
Detecting center point of cross using Matlab	matlab
Graph/tree representation and recursion.	matlab
MATLAB image corner coordinates & referncing to cell arrays	matlab
How to merge a 64 by 64 cell into a 1 by 1 cell	matlab
What does  ~= mean in MATLAB?	matlab
Can someone explain what the output of fft means in MATLAB?	matlab
Matlab: avoiding memory allocation in mex	matlab
Special functions in Matlab	matlab
Matlab object array method dispatching	matlab
Is there a way how to run matlab script from specific line without gui?	matlab
Brackets at the start of input in matlab ?? [ x , y ] = ....	matlab
Plot Overlay Matlab	matlab
two arrays defining 2d coordinates, as array indices, in matlab/octave	matlab
How can I tell how much memory a handle object uses in matlab	matlab
Matlab - applying low-pass filter to a vector?	matlab
How do I abort a MATLAB m-file function from C/C++?	matlab
How to import and plot data from a .mat file to x and y variables ?	matlab
Matlab Simulation: Point (symbol) Moving from start point to end point and back	matlab
Importing matlab functions in matlab	matlab
half-sine pulse shaping	matlab
Extended maxima transform in Matlab	matlab
Putting together a big stiffness matrix from several small ones	matlab
Matlab symbolic toolbox: What's wrong with my code?	matlab
How to format a input vector from the input data in MATLAB?	matlab
Unpacking varargin to individual variables	matlab
MATLAB testing framework	matlab
Insert doubles in cell array into vector in Matlab	matlab
Introduction to vectorizing in MATLAB - any good tutorials?	matlab
"MATLAB ""bug"" (or really weird behavior)"	matlab
Matlab - Speeding up a Nested For Loop	matlab
How do I count the number of persons in an image using MATLAB?	matlab
plotting matworks logo and heartshape	matlab
Stacking several 2D images into 3D in Matlab	matlab
Matlab interview questions?	matlab
Draw a textured triangle (patch) in Matlab	matlab
How do I change the Unit:Characters in Matlab?	matlab
Embedded Matlab: Problem with persistent variables.	matlab
How do I update the matlab path?	matlab
I need to order a list that is dependant on another list. how to change both lists?	matlab
MatLab (martix concetenating)	matlab
Matlab GPU acceleration for loading large point cloud dataset	matlab
MATLAB - printing graph with different output names	matlab
MATLAB Array Manipulation	matlab
MATLAB arbitrary code execution	matlab
MATLAB: split long 2D matrix into the third dimension	matlab
matlab: collect from array of structs	matlab
Matlab: Find all NaN Elements inside an Array	matlab
How to create a executable .exe file from .m file	matlab
matlab oop: too slow to be useful ?	matlab
"exchange axis of an ""ezplot"""	matlab
Handling large amount of structures in MATLAB	matlab
Checking if a matlab handle is a valid one	matlab
Porting MATLAB 7 files back to 6.1	matlab
MATLAB How to divide a matrix into equals parts?	matlab
simple problem with matlab	matlab
[ MATLAB ] For loop to extract info from a structure doesnt work ?	matlab
Naming convention of im2bw in MATLAB	matlab
Matlab subclassing question	matlab
Matrix of unknown length in MATLAB?	matlab
Plotting Bessel functions	matlab
Neural network XOR backpropagation info needed.	matlab
Matlab, index from starting location to last index	matlab
In Matlab, how do I change the background color of a subplot?	matlab
Using Matlab to find maxima for data with a lot of noise	matlab
What's this setting of MATLAB for(which is causing lots of troubles for lots of people)?	matlab
How to determine where a number is printing from in matlab?	matlab
MATLAB's hmmtrain assumes initial transition from state 1	matlab
tformfwd and tforminv - what's the difference?	matlab
Simple question about text in Matlab	matlab
Matlab: Analysis of signal	matlab
How to run matlab codes from java end.	matlab
Matalb: convert global coordinates to figure coordinates	matlab
wx file error when using Haskell	haskell
Haskell Pattern Matching on the Empty Set	haskell
Haskell and Conditional Data Structures	haskell
Using Haskell for sizable real-time systems: how (if?) ?	haskell
Improve my Haskell implementation of Filter	haskell
Why can't GHCi resolve the kind of [[]] ?	haskell
Haskell readFile type problem	haskell
What is a common idiom for converting between Integral types?	haskell
Evaluation of Haskell Statements/Expressions using GHC API	haskell
How does 'get' actually /get/ the initial state in Haskell?	haskell
"(newbie) type signature ""Maybe a"" doesn't like ""Just [Event]"""	haskell
How composite function with arbitrary arity in Haskell?	haskell
trying to install hs-ffmpeg haskell package fails to find libdc1394	haskell
Body Mass Index program in haskell	haskell
is there a way for keeping a variable from changing inside recursions, in haskell?	haskell
understanding syb boilerplate elimination	haskell
How do I do automatic data serialization of data objects in Haskell	haskell
Handling incremental Data Modeling Changes in Functional Programming	haskell
Help Understanding Arrows in Haskell	haskell
Applying a function with multiple inputs using Map? (Haskell)	haskell
Are Rank2Types/RankNTypes practical without polytype variables?	haskell
Haskell XMLRPC server executing dynamically generated functions	haskell
changing search-dirs for $ sudo gcc	haskell
Control.Monad.State found in multiple packages haskell	haskell
Haskell Parse Paragraph and em element with Parsec	haskell
Having trouble writing my fmap	haskell
Polyvariadic Functions in Haskell	haskell
Generating Fibonacci numbers in Haskell?	haskell
Haskell: What's the type of this function?	haskell
Haskell: Custom types with conditions	haskell
'mod' and -1 in haskell	haskell
Haskell, Lisp, and verbosity	haskell
How do I use Data.Concurrent.mergeio?	haskell
What is the relationship between unboxed types and strictness?	haskell
Why do compiled Haskell libraries see invalid static FFI storage?	haskell
how to simulate the concept of object identity in Haskell	haskell
A Haskell function of type: IO String-> String	haskell
Improve a haskell script	haskell
Convert list of Integers into one Int (like concat) in haskell	haskell
How do I install nano-hmac on Mac OS X?	haskell
Haskell: -fglasgow-exts should one avoid code that requires this?	haskell
[Haskell] Problem when mixing type classes and type families	haskell
Haskell - interpreting a number	haskell
"Continuation monad ""interface"""	haskell
Type classes in Haskell data types	haskell
How do you do generic programming in Haskell?	haskell
Reasoning about performance in Haskell	haskell
Haskell: Dealing With Types And Exceptions	haskell
Filter/Map composition problem Haskell	haskell
Haskell type cast problem	haskell
How do you make this Haskell power function tail recursive?	haskell
elemIndices in Haskell	haskell
What's the fuss about Haskell?	haskell
Y-Combinator in FT EDSL	haskell
How to make an unboxed array of floats I can get a Ptr to	haskell
Lifting class instance in Haskell	haskell
What does the `forall` keyword in Haskell/GHC do?	haskell
Mapping the :edit command to a certain editor	haskell
Haskell: generic IORef, MVar?	haskell
adding other files to haskell	haskell
Haskell execution sequence	haskell
haskell recursive function	haskell
Haskell Type error	haskell
Haskell: Defaulting constraints to type	haskell
Why are side-effects modeled as monads in Haskell?	haskell
How to programmatically retrieve GHC package information?	haskell
Generating a list of lists of Int with QuickCheck	haskell
Haskell - how to write array to file?	haskell
Is there a Haskell compiler or preprocessor that uses strict evaluation?	haskell
save graphs in Haskell	haskell
Haskell cabal+hsc2hs	haskell
Replacing an element in a n-ary tree	haskell
What's new in QuickCheck 2?	haskell
What does a fullstop (.) mean in Haskell?	haskell
Split ByteString on a ByteString (instead of a Word8 or Char)	haskell
Using haskell read and typeclasses - ambiguous type variable error	haskell
Multiple actions upon a case statement in Haskell	haskell
how to write a foldr HOF in Haskell	haskell
Memoization & Project Euler Problem 15 in Haskell	haskell
Is Haskell mature enough for developing commerical web applications?	haskell
How do I remove every occurance of a value from a list in haskell using Prelude?	haskell
How to mix binding (<-) and assignment (let) in one line? (in Haskell)	haskell
When to exploit type inference in Haskell?	haskell
Why does Haskell stop short of inferring the datatype's typeclasses in the function signatures?	haskell
What programming task provided your breakthrough with monads?	haskell
Haskell Ambiguous Occurrences -- how to avoid?	haskell
regular expression in haskell	haskell
N-queens in Haskell without list traversal	haskell
How to customize the readline keybindings of ghci	haskell
List construction in Haskell	haskell
Distributing a Haskell program as C source	haskell
what's the way to determine if an Int a perfect square in Haskell?	haskell
haskell polymorphism and lists	haskell
Haskell - How to best to represent a programming language's grammar?	haskell
Haskell foreign import stdcall on DLL function	haskell
Haskel dot (.) and dollar ($) composition: correct use.	haskell
Haddock losing part of the documentation?	haskell
Haskell pixel drawing library linux	haskell
Writing a function with a universally-quantified return type	haskell
C stack overflow on Project Euler Problem 27	haskell
In Haskell, how do I recursively manipulate a tuple and preappend a character to the first element in the tuple?	haskell
Haskell parser error in where clause	haskell
How do I test if a floating point number is an integer in haskell?	haskell
Efficiency of equality in Haskell	haskell
Comparing 3 output lists in haskell	haskell
Haskell numeric type heirarch in SICP exercises	haskell
Using the Github Gist API from Haskell	haskell
How to format numbers according to locale in Haskell?	haskell
"Please confirm or correct my ""English interpretation"" of this Haskell code snippet"	haskell
Why is this Haskell incorrect?	haskell
List of existentially quantified values in Haskell	haskell
[Haskell] Set of an Unordered Data Type with a given ordering	haskell
Cabal and zlib on OS X	haskell
Laziness and tail recursion in Haskell, why is this crashing?	haskell
Doing a binary search on some elements in Haskell	haskell
Types in Haskell	haskell
Is it possible to change the step size of the built-in haskell range function or literal?	haskell
How can I factor this Haskell expression to avoid repeated computation?	haskell
lists searches in SYB or uniplate haskell	haskell
Haskell: looking up the second value of a tuple in a list based on the first value	haskell
Why toInteger :: Int -> Integer is lazy?	haskell
Parsec Haskell Lists	haskell
Linking/Combining Type Classes in Haskell	haskell
On Cygwin, how do I install curl from hackage?	haskell
stm monad problem	haskell
Stack overflow in OCaml and F# but not in Haskell	haskell
What manner of Haskell syntax is used in [$parseRoutes|/ Home GET|] ?	haskell
Complete Haskore example	haskell
Intermediate lists in Haskell	haskell
haskell libmagic  how to use it???	haskell
Keep track of the program variables in Haskell like imperative programs	haskell
Literate Haskell (.lhs) and Haddock	haskell
mail reader using haskell	haskell
how to execute haskell program in cygwin	haskell
Different results when applying function to equal values	haskell
Is there an encyclopedia/list of common type classes in Haskell?	haskell
Haskell script running out of space	haskell
Does Haskell have Variables	haskell
Creative uses of monads	haskell
Guard is skipped when it should not be.	haskell
Return specific type within Haskell	haskell
Haskell sorting of an unorderable list using a proxy order	haskell
Is Haskell really a purely functional language?	haskell
Haskell -- problem with pretty-printing a list	haskell
GHC parse error which I do not understand	haskell
Flowcharting functional programming languages	haskell
In Haskell, how can I use the built in sortBy function to sort a list of pairs(tuple)?	haskell
Are these two combinators already available in Haskell?	haskell
Problems with scrolling in TextView in Gtk2hs and Haskell.	haskell
How to work with assertEqual with parameterized types	haskell
Hierarchical Wordpress page nav with all permalinks in the root	wordpress
Wordpress blog + Google AdSense	wordpress
Calling wordpress API from Zend pages on same box	wordpress
WordPress plugin: finding the <!--more--> in the_content	wordpress
What's best way to format C# in WordPress?	wordpress
Wordpress SEO Features	wordpress
Wordpress loop > unique loop renders slightly wrong results...	wordpress
How do I get wordpress to override a previous posts query?	wordpress
retrieve only sub-pages (wordpress)	wordpress
Wordpress Term exist not having desired effect	wordpress
How do I show the 'blog last updated' time in Wordpress?	wordpress
Wordpress: If two or more posts have same date, date is not shown.	wordpress
Adive on Wordpress or Framework?	wordpress
Create custom rewrite rule for my WordPress plugin	wordpress
Why do my Wordpress comments have the wrong date?	wordpress
Retreiving widget data with MySQL query in WordPress	wordpress
Codeigniter In Wordpress Page	wordpress
Wordpress plugin for enhanced WYSIWYG image resizing?	wordpress
Ordering Wordpress posts by most recent comment	wordpress
Pull data from WordPress	wordpress
How Can a Plugin Hijack a URL in WordPress?	wordpress
Writing MS Word 2007 XML	wordpress
"wordpress- have a specific type of ""page/post"" as ""testimony"". Possible? If so, how?"	wordpress
How can I make custom Wordpress comments form?	wordpress
Wordpress limits - system design consideration.	wordpress
Can I use a wordpress theme in new php pages?	wordpress
"Wordpress: wpdb->insert VERSUS wpdb->prepare(wpdb->query(""INSERT..."	wordpress
How make custome post template in Thesis theme	wordpress
WordPress theme blog not displaying well in FireFox-how to fix?	wordpress
How to place comments through the Comment Approval Process in Wordpress?	wordpress
Returning Wordpress Custom Field Values	wordpress
wordpress  plug-ins, themes and widgets  tips and tricks	wordpress
WordPress 2.8.6 foobars my theme options with escape slashes!	wordpress
How can I tell my wordpress to do something in the header if its a blog page?	wordpress
LAMP tutorial. Request->response loop from the ground up.	wordpress
How do you simply add new custom rewrites to the .htaccess of a wordpress without fail?	wordpress
Wordpress: query all images in a posts media library	wordpress
Wordpress: Accessing A Plugin's Function From A Theme	wordpress
Wordpress register_activation_hook() + global variables + class problem	wordpress
Wordpress Default Widgets	wordpress
Feedburner Subscribe box in wordpress blog	wordpress
How to define certain posts as featured posts in WordPress?	wordpress
Wordpress : is it possible to connect $wpdb class into other database ?	wordpress
"where do i find the wordpress ""promote"" class?"	wordpress
Wordpress plugin to track logged users activity	wordpress
the administration section where i post blogs. the textarea height is set to 209px how to change this?	wordpress
Adding posts with thumbnail programatically in WordPress	wordpress
Wordpress search goes to mainpage	wordpress
No feed output when working with Friendfeed and Wordpress API?	wordpress
creating rss.xml file for wordpress posts...	wordpress
How can I attach a file using Wordpress custom fields / meta boxes?	wordpress
How can I pass variables from a form within the Wordpress platform?	wordpress
Query to Delete Posts Older than X Days in WordPress	wordpress
Weird problem using custom fields	wordpress
wp_list_authors wordpress Author List want to fetch gravatar and bio	wordpress
Font of page title appears different on browsers in Windows and on Linux	wordpress
Patch for Wordpress Remote Admin Reset Password Vulnerability	wordpress
Replace author url with different one	wordpress
Sequincial order of wordpress hook ?	wordpress
Wordprss permalinks set	wordpress
Wordpress Base Path Hook?	wordpress
How do I  install and use wordpress.org  GeSHi syntaxhighlighter	wordpress
How can I debug WordPress in IIS?	wordpress
date and time settings dont show up properly in wordpress 2.8.6	wordpress
Extract image from the content	wordpress
Wordpress plugin: ajaxStart conflict in Post page (autosave)	wordpress
Is there a way to change (delete) a standard phrase going after a single post in Wordpress?	wordpress
Displaying static information in a Wordpress blog	wordpress
Show Only Pings (Pingbacks+Trackbacks) Number on Wordpress	wordpress
How to make a clickable header in wordpress?	wordpress
Wordpress Widget Redirect Page	wordpress
Wordpress Custom Value If/ElseIf - Doesn't Work	wordpress
How to check if a post belongs to a category in Wordpress	wordpress
How Do I Programmatically Check if a WordPress Plugin Is Already Activated?	wordpress
How to pass URL variables into a WordPress page	wordpress
Change post categories while saving post	wordpress
WordPress Code Snippet Help	wordpress
wordpress not properly functioning anymore after moving it to another domain	wordpress
The RSS Feed of Wordpress blog goes wild	wordpress
Dropdown menu in IE6 inserting too much width, not dropping-down	wordpress
Remove main editor from wordpress edit page screen	wordpress
How can I stop PHP notices from appearing in wordpress?	wordpress
plugin for 2.0 insert on wordpress	wordpress
Can't echo wp_count_posts('page')???	wordpress
Using jQuery Plugins with Wordpress	wordpress
Recommendations, thoughts, tips and tricks, or peanuts on moving from wordpress to django	wordpress
Diplay Wordpress Archives one category at a time?	wordpress
Thumbnail wordpress plugin	wordpress
display author URL in single	wordpress
Wordpress is ignoring Unicode Chars in URL	wordpress
PHP regex expression for the following...	wordpress
What's wrong with this code logic?	wordpress
Fetch posts starting with alphabet [x]	wordpress
Which CMS do I need? Needs to be easy to post a certain kind of post	wordpress
Manually highlight Wordpress admin menu item.	wordpress
tinyMCE & wordpress giving odd characters... tried combination of solutions...	wordpress
Padding has blue border in IE and Firefox but not in Chrome.	wordpress
Format dates in a WordPress plugin	wordpress
Wordpress vulnerabilities test scanner	wordpress
Wordpress: get last post belonging to a category, when listing categories	wordpress
Generic Category Sidebar in Carrington Wordpress Theme Framework	wordpress
wordpress, cron & time - does time on server affects plugins? how to fix it?	wordpress
wordpress - how to get php variable in page from sidebar	wordpress
"how to  find and clean wordpress from script/s that changes your blog posts titles on Google and yahoo with embarrassing ""Vigra  text""?"	wordpress
How remove iFrame from wordpress admin panel?	wordpress
How Does WordPress Block Search Engines?	wordpress
Submit WordPress form programmatically	wordpress
How would you recommend adding an image as a custom field in WordPress?	wordpress
Wordpress root directory	wordpress
How to add url shortener API to wordpress posts links?	wordpress
wordpress plugin to upload file directly to amazon s3	wordpress
Image gallery in wordpress	wordpress
Wordpress 2.8+ and IE8 display problems?	wordpress
WP_Insert_Post and GUID Issue [Wordpress]	wordpress
Which additional securities do you add to your open source cms installations?	wordpress
How to include the post-count of a category to link-item when listing categories?	wordpress
How can I rename (or even remove?) buddypress' wire-section?	wordpress
Wordpress removing WWW	wordpress
You do not have sufficient permissions to access this page.	wordpress
Wordpress site painfully slow...	wordpress
"WordPress: I got rid of the second ""home"" page, but it's not good enough"	wordpress
Wordpress: how to make a post template with a fix image placement??	wordpress
A way to add Oscommerce cart items to a Wordpress Widget	wordpress
Wordpress - failed to write to disk MOV file	wordpress
Auto Refresh Wordpress Post Div	wordpress
Wordpress Inline Images - Does it ignore the right margin values?	wordpress
Category as a Horizontal menu in wordpress	wordpress
Upgrading my Wordpress installation...click and pray?	wordpress
Display posts from x cat and y tag	wordpress
Wordpress authentication and login manager	wordpress
HTML anchor too pull all Sticky Posts ?	wordpress
wordpress how to add another page?	wordpress
Cannot see my wordpress website on google search	wordpress
Wordpress custom theme's 404.php > Does Google see it as a true 404 redirect?	wordpress
Wordpress Install on OS X Snow-Leopard under Sites/public for use with capistrano	wordpress
Editable content area for user with restricted access	wordpress
Best way to get post info into variables without displaying them in Wordpress	wordpress
Where is the template file for the password protected page in wordpress?	wordpress
Wordpress page navigation	wordpress
Wordpress: wp_insert_post fails to add comment_count	wordpress
wordpress conditional statements	wordpress
adding single.php page to wordpress or if condition for main page or post detail page...	wordpress
How to add a div class to Wordpress Auto Nav?	wordpress
Is there a function to get the caption for an image in wordpress	wordpress
Code to have Wordpress display a monthly archive?	wordpress
Wordpress search results on external page	wordpress
Use first post as start-page in wordpress	wordpress
Is it possible to have comments without blog post in Wordpress?	wordpress
Alternate posts in wordpress	wordpress
Wordpress - Create a splash screen without affecting search engine results	wordpress
Spring parent and child resources	spring
Spring JDBC connection pool and InputStream results	spring
Cannot get bean from flowScope	spring
Ready configurations for Spring + Hibernate	spring
How can we share data between the different steps of a Job in Spring Batch?	spring
scope of a controller and a validator	spring
Spring 3: task namespace: How to find out time of next execution?	spring
Any existing way to make sure beans defined in spring xml are stateless?	spring
Spring Faces Javascript	spring
How to make Spring load a JDBC Driver BEFORE initializing Hibernate's SessionFactory?	spring
map url to controller	spring
Using Spring Pitchfork to have JEE complaint code that runs in non-JEE container	spring
LazyInitializationException in Spring	spring
How do i display non-validation errors in jsp with spring webflow	spring
Spring context files organization and best practices	spring
problem in Spring session scope bean with AOP	spring
Spring and view resolvers	spring
error handling with spring + servlet spec	spring
EntityManager refresh problem	spring
What does <tx:annotation-driven/> in Spring really do in the code level ?	spring
Real life business case for using spring method replacement?	spring
Spring + Hibernate + JPA	spring
Spring RuntimeBeanReference	spring
Does it make sense to have more than one MethodSecurityInterceptor bean?	spring
c:foreach using List: Must evaluate to a Collection, Map, Array, or null	spring
Spring RegisterSingleton	spring
Spring Security 3.0 and Active Directory LDAP: DOMAIN\user login	spring
have you tried the Spring Workflow alreay ?	spring
Add Principal/authority dynamically for anonymous user	spring
Spring AOP: applying properties through the aspect	spring
Spring, JDBC & MultiThreading	spring
Spring queryForLong - Loss of precision	spring
Spring DefaultMessageListenerContainer, ActiveMQ and message redelivery	spring
SimpleFormController help	spring
Spring DI, Domain Model & best practices	spring
How can I cancel a long-running query using Spring and JDBCTemplate?	spring
Spring: I wish to create a junit test for a web application - WebApplicationContext needed	spring
<on-start> Expression	spring
Integrating Spring + Hibernate + Sql server with unicode support	spring
Single DispatcherServlet with Multiple Controllers	spring
<security:custom-authentication-provider /> means?	spring
SimpleJdbcTestUtils.executeScript and multilines script	spring
Using Spring AOP in an JSF application	spring
Service activator method mapping using @Header annotation in Spring Integration	spring
Can't I use annotation to indicate a bean is a primary bean	spring
spring beans configuration	spring
how to do background computing in Spring 3.0?	spring
Spring RDBMS vs JDBCTemplate	spring
Convert XML based configuration to Annotations	spring
Spring bean with no id or name	spring
@Autowire strange problem	spring
Spring + Hibernate - multiple databases	spring
log4j:WARN No appenders could be found for logger in web.xml	spring
Spring application root variable	spring
Spring initialization order	spring
Spring + Hibernate Dynamic Mapping	spring
jpaTamplate how to autocommit...?	spring
creating inner classes with spring	spring
Dynamic injection of bean properties based on a locale variant in Spring	spring
Spring Test / JUnit problem - unable to load application context	spring
What is the equivalent of Struts ActionMessages in Spring MVC?	spring
Spring Security Max Login Session	spring
spring vs ejb. can spring replace ejb?	spring
"Proper way of ""shutdown"" a spring context in J2SE"	spring
integrating springMVC and extjs	spring
Reading annotation property in aspect	spring
Spring MVC Custom Authentication	spring
Spring 3.0 EL How to get property from a properties file?	spring
How to mock a static variable in java using JMock	spring
ref vs idref attributes in spring bean declaration	spring
Which hibernate adapter should I use to handle Lazy Initialization in BlazeDS / Spring integration projects with Flex?	spring
Best way to force Spring shutdown from a bean?	spring
How does Spring for Python compare with Spring for Java	spring
Load Balancing, Spring Security, ConcurrentSessionFilter	spring
Spring Annotation-based controllers not working if it is inside jar file	spring
ACL architechture for a Software As a service in Sprgin 3.0	spring
Spring Web Flow form binding	spring
How can I determine Objects in application context?	spring
org/springframework/metadata/Attributes not found in spring3.0?	spring
Spring Autowiring class vs. interface?	spring
How do I configure Spring Security 2 database authentication with Hibernate 3 Annotated Classes?	spring
Spring MVC Domain Object handling Best Practice	spring
How configure a RESTful controller in Spring 3 with annotations?	spring
Access bean name in custom method interceptor	spring
Spring 3 on GlassFish 2.1 java.lang.NoSuchFieldError: APPLICATION_CONTEXT_ID_PREFIX	spring
caching per request in ASP.NET?	spring
How to Inject Spring  ReloadableResourceBundleMessageSource	spring
How to use CurrentSessionContext/SpringSessionContext along with HibernateDaoSupport to intercept calls to getCurrentSession()	spring
org.springframework.transaction.annotation.Transactional vs javax.jdo.annotations.Transactional	spring
Spring Calls Object Constructor Before Setting Properties	spring
Flex + Spring + BlazeDS + Glassfish + OpenMQ - How do you configure the web-application-config for OpenMQ?	spring
How to inject spring beans into a jsp 2.0 SimpleTag ?	spring
What is the difference between putting @Autowired to a variable and a method ?	spring
spring annotation configration issue	spring
Use Spring annotations to automatically apply Hibernate Interceptor?	spring
spring+hibernate mapping class without xml	spring
Spring 2.2.5 and Xfire 1.2.6 - NoSuchMethodError: <init>	spring
How to throw an informative exception from AccessDecisionManager that uses voters	spring
How does Spring maintain singletons,prototypes... under the hood?	spring
How can I translate text inside controller in Spring Framework 3 ?	spring
@ContextConfiguration in Spring 3.0 give me No default constructor found	spring
How can i register a global custom editor in Spring-MVC ?	spring
Add SoapHeader to org.springframework.ws.WebServiceMessage	spring
Getting Spring Application context from a non bean object without using Singleton	spring
Spring Security: Redirect to invalid-session-url instead of logout-success-url on successful logout	spring
google gin? use with spring?	spring
Spring Security Logout	spring
How does transaction propagation work when using Open Session In View?	spring
Problem managing session with multiple data sources	spring
Is it possible from Spring to inject the result of calling a method on a ref bean?	spring
How assign bean's property an Enum value in Spring config file?	spring
Spring 3 simple extentionless url mappings with annotation-based mapping - impossible?	spring
Problem migrating Spring Web App from tomcat 5.5 to tomcat 6.0	spring
Which view will be resolved, code from spring's docs	spring
Spring: Remove singleton	spring
argh - can't get spring to log sql	spring
What is detached  persistance and transient object in hibernate ?	spring
What's mean that Caused by: javax.validation.ValidationException: Unable to find a default provider ?	spring
What is the problem with not using Spring	spring
Translate Spring XML configuration to Java config	spring
Jersey w/ Spring 3.0?	spring
spring enabled web application	spring
Q about AbstractApplicationContext.getBeansOfType() and getBean()	spring
spring: a bean that receives a list of Classes	spring
Spring 3 Java Config: Imported @Configuration not enhanced?	spring
Spring 3.0 making JSON response using jackson message converter	spring
Naming convention for Spring application context XML	spring
How can I determine what roles are required to access a URL with Spring Security?	spring
Ant target for compile-time code instrumentation with Spring aspects	spring
Spring map definition	spring
Spring and hibernate.cfg.xml	spring
What's the difference between Tomcat JNDI based and Spring/Hibernate DS based connection pooling	spring
How to perform spring validation  in multiaction controller?	spring
How can use Spring XML configuration to set a bean property with list of all beans of a certain type?	spring
Lazy initialiazation of cache with Spring IBatis	spring
How can I access path variables in a URI template in the view (Spring 3/SpringMVC)?	spring
call valang validator in MultiActionController ModelAndView method... possible? how?	spring
how to configure java.xml.transform.transformer in spring	spring
how to conditionally show jsp content to logged in users with Spring security	spring
In a mvc application, where will the DI take place?	spring
Spring application context : webapp folder variable ?	spring
DB backup problem with Spring/Hibernate GenerationType.AUTO	spring
Is Spring hard compaired to Ruby on Rails?	spring
How do I prevent Spring/Hibernate from automatically committing my modifications to the database?	spring
Why is SpringSource Tool Suite (STS) so slow? And how can I fix it?	spring
programmatically create a spring context	spring
Autostart spring app	spring
spring JDBC	spring
Spring JDBC RowMapper with Class Hiearchies	spring
spring: set property of one bean by reading the property of another bean?	spring
Updating frontend layout from a module	magento
Magento failure.phtml, get the order total	magento
Extra Customer Functionality in Magento	magento
Magneto as B2B - view 'company name' instead of first/last name	magento
configurable product Issue	magento
Pulling in Magento Session Information is buggy	magento
"Magento flat product table - retrieving ""Most Viewed"" product names"	magento
Changing Design For All Module Pages In Magento	magento
magento example module	magento
magento show products in left side bar	magento
What shopping cart is the most scalable?	magento
Magneto performance tunning	magento
Magento search not returning expected results	magento
Magento - get list of items from orders for specific date range	magento
Magento - send newsletter subscription information as email	magento
How to direct link to an attribute set?	magento
Magento 3.1 - Left Hand Menu	magento
Magento as low as price displays on some pages but not all?	magento
Instantiate dynamic array Magento	magento
Changing the Access Denied Message in Magento	magento
upgrade magento latest version from 1.1.3 through admin dashboard	magento
Show product creation & last edit dates on Frontend in Magento	magento
Magento design possible in all pages?	magento
"Magento xml layouts - before=""-"" not working in 1.4.2"	magento
Magento - Buy it now buttons and checkout process	magento
Get customer in Mage_Tax_Model_Calculation::getRate in magento	magento
local vs core contoller	magento
Unsolvable Magento Cart problem	magento
Viewing Magento model data changes on before/after save event?	magento
Moving advanced search - Magento	magento
Magento locate CMS page in cms.xml	magento
installing magento plugins without using magento connect	magento
How to get last running transaction Id in magento	magento
Setting a global variable in Magento, the GUI way?	magento
magento customer creation and guest to be converted to regular customer	magento
Magento backend problem	magento
Join tables to get sold products	magento
Magento Debugging Environment	magento
What is the cheapest payment processing system for Magento?	magento
Magento Associated Product Options	magento
SEO for a Magento multilingual store	magento
magento chnge feture product change	magento
Show price inc VAT for UK users only	magento
what would be the best solution to arrange items on Magento?	magento
Magento; private/public filesystem layer	magento
change column-layout of contact form in Magento	magento
Magento custom module image restore	magento
magento - add links to footer but not to top navigational menu	magento
Magento - link to a frontend skin js file from an admin file	magento
Change the customer password field Magento	magento
Problems in installation of magento on wamp	magento
Magneto XML layout with custom modules	magento
using group() breaks getSelectCountSql in magento	magento
How to integrate ezComponents with magento	magento
Magento: Fixed shipping cost BELOW certain basket price.	magento
What's the best way to have multiple groups of simple featured products in Magento?	magento
"Magento - change ""Catalog Input Type for Store Owner"""	magento
Magento - Display Individual Products	magento
Multi-part clothing store in Magento.	magento
my Magento Observer is getting in Endless loop	magento
Magento - Move a category programmatically	magento
magento payment process.. how it works in general	magento
Changing a Magento default theme	magento
Urgent! Magento never run my module's sql install/update script!	magento
Magento - How to check if a product has already been removed from the cart	magento
Country name based themeing system on  Magento	magento
Customizing Magento Sidebar	magento
"How do I display breadcrumbs on ""Products tagged with"" pages in Magento?"	magento
Add page title to custom theme on Magento	magento
magento Baseurl from helper function	magento
Magento - Checkout not redirecting to success page	magento
How to get the reference to a model object instance in Magento	magento
How to check CMS block is active?	magento
[MAGENTO] Redirect to checkout onepage after adding item to cart	magento
update magento currency rates using custom php file	magento
Best method for importing configurable products into Magento	magento
Magento products will not show in category	magento
Magento - Configurable products not visible until manually saved in admin panel	magento
how to add more simple products into configurable products using magento API	magento
how to call a static method in a custom magento class	magento
How can I edit a specific item on my website's front page on Magento	magento
Partial refunds in Magento	magento
How to add a column for example customer group id in Magento's Admin Order Grid	magento
Add a free product if over Â£50	magento
Set session time out limit for magento frontend	magento
Magento onepage issue	magento
Using Magento 1.4's WYSIWYG editor on custom admin pages	magento
Magento e-Commerce cannot generate reports	magento
Magento Flash + XML frontend	magento
Magento: What is the best way to extend Magento to add a class that is called on every page load	magento
Are All Price Values in catalog_product_entity_decimal ?	magento
Remove CA from before teh $ in magento	magento
magento simple product link to open grouped products page	magento
Magento add rate options to products	magento
Magento Email Template Help	magento
What are the best steps to improve magento performance?	magento
Magento: Multiple calls to same block template with cache on	magento
Magento - getting the wrong number of the method count()	magento
Custom cases of product in Magento?	magento
Magento - how to create different prices for different sizes of a products?	magento
Filter collection by attribute Set	magento
Magento admin extension fails to show in live server menu bar	magento
Making Category Image a link	magento
Magento - Add bundled products from PHP with Magento API	magento
How to get All Credit card Details entered by Customer till now in Magento?	magento
Issues with Cufon in Magento	magento
Using Magento Methods to write Insert Queries with care for SQL Injection	magento
How to add limit option in Magento API call.	magento
Magento : Call to a member function count() on a non-object	magento
Shipping cost calculate	magento
Magento adding new options to a drop down attribute.	magento
error :php extension curl must be loaded	magento
Magento: Can you set it so all Websites share the same order increment id sequence?	magento
Magento Custom Forms	magento
In Magento, how can I organize products from different categories under a parent entity which in turn has it's own attributes?	magento
how to add Adding external javascript in magento.	magento
Magenot: Difference between loading product through collection than product model	magento
Where is The Abandoned Cart Report Located in Magento?	magento
Magento - How to display ALL PRODUCTS in the homepage?	magento
Magento: Show the Review Step in One Page Checkout	magento
show the order display page in new page in magento	magento
Are my Magento permissions correct?	magento
Best book for Magento 1.4.0.1	magento
After overriding contoller how to best update handles	magento
Magento order import export	magento
Magento 1.4 paypal bug	magento
magento bundle product displaying as out of stock	magento
Magento - Display Attribute Admin Title	magento
Events not firing/or observer not working in magento	magento
How to get a Magento product collection as a comma separated list of SKU's	magento
magento router: How can i catch parameters in all urls?	magento
magento 1.4 very slow on localhost	magento
Magento Community Edition Capability Questions	magento
Bundled Product add new option error	magento
What Confuses you about Magento Widgets?	magento
how can i get all order id in magento	magento
magento _redirect with parameters that have + or /	magento
how to add content to the right structural block in magento	magento
Magento: change to Product Name or Description not displayed on frontend.	magento
magento setup problem.	magento
Magento: Rebuilding Flat Catalog Programmatically	magento
Magento - Move Code from view.phtml to tabs.phtml	magento
Favicon.ico on multi-domain sites?	magento
Paypal Standard option does not appear on the Checkout page	magento
How does Magento code work?	magento
Is there a way to refresh Magento *Catalog* (not Shopping Cart) prices with a Coupon code?	magento
Magento: Filter Configurable Product by their options	magento
custom attribute UI in Magento admin	magento
Magento : call a variable from customerâ€™s shipping address in Onepage checkout, step 3 shipping method	magento
Toggle Shipping Methods Based on Products	magento
How do I get Srcsrv with SVNindex.cmd to index extern files ?	svn
How can I downgrade the version of an SVN working copy?	svn
Team Foundation Server - Use API to Sync to SVN	svn
Subversion cross-file keyword substitution	svn
include externals in subversion diff	svn
How do I convince my team to drop sourcesafe and move to SVN?	svn
How do I find how much SVN traffic I'm using?	svn
Branching from deleted path in svn	svn
How to maintain a locally modified copy of an external svn repository	svn
trac-past-commit-hook on remote repository	svn
In what OS should I host subversion?	svn
Subversion for iSeries	svn
Subversion: Retract Accidental Checkin	svn
resolving svn binary conflicts	svn
How do I set up an asp.net mvc app with Subversion?	svn
examining Subversion history of deleted file	svn
How can I make only some folders show up for certain developers with SVN	svn
How can I get the functionality of svn:externals in a read-only fashion?	svn
SVN - Project in multiple solutions	svn
Standard diff format in SVN	svn
svn: Path does not exist in revision	svn
Best practices for using Subversion on a development server?	svn
Best way to let third-parties work on your site	svn
Codeplex SVN $Author$ Property problem	svn
How do you arrange several proyects in a single SVN server?	svn
Using Mercurial Locally Only with Subversion Server	svn
"i am looking for svn admin like ""VisualSVN Server"" for remote server?"	svn
svn create tag problem	svn
Better Merge Tool for Subversion	svn
Ignore SVN ignore... possible?	svn
Unlocking a SVN working copy which has unversioned resources	svn
SVN and renaming the server it's running on	svn
How to get all changes with an svn update, using TortoiseSVN	svn
subversion upgrade question - 1.5.3 to 1.5.4	svn
Folder structure for many projects in one SVN repository?	svn
How do you move a file in SVN?	svn
Subversion: How to merge only specific revisions into trunk?	svn
Is a good idea to put all projects in the same trunk?	svn
Piping data on Windows command prompt	svn
A command line that yields the complete URL of a file inside the svn repository?	svn
Best strategy for branching SVN code and maintaining Visual Studio project references	svn
Are merges in subversion more difficult than in Team Foundation System?	svn
What are patches used for in SVN?	svn
What  is the best practice regarding Source code managment ?	svn
How can a SVN repository become corrupt?	svn
return subversion working copy to an old revision	svn
How to check out a Subversion repository using svn+ssh protocol?	svn
How can I enforce a reviewers name being entered into SVN log	svn
Credential Caching Fail on SVN 1.5.2	svn
SVN: Can I copy a subset of files to a new tag?	svn
Subversion and revision engineering - what are the best web resources to read about?	svn
Subversion merge history visualisation	svn
Ever need to parse the svn log for files committed by a particular user since a certain date?	svn
svn import adds and commits a dir,but dir cant be browsed..	svn
"How should I Fix ""svn: Inconsistent line ending style""?"	svn
How to recover from svn hotcopy backups	svn
How do you version your database schema?	svn
Is it acceptable/good to store binaries in SVN?	svn
How to programatically  do file versioning with SVN and .NET?	svn
Best way to use Subversion as a project communication tool?	svn
Pattern matching characters for svn:ignore	svn
How do I correct a Subversion project where I omitted trunk?	svn
"Subversion ""Suite""?"	svn
Using SVNSERVE to host Subversion server, configuration files, etc.	svn
Migrating from SVN to Perforce -- Tips?  Experience?	svn
Which version control tool is best sutiable to handle reflective or cyclic mergeing? SVN, Git?	svn
SVN log not showing all the revisions made to a file	svn
Undo SVN delete ./* --force	svn
How to set author name for subversion when i'm using svn:keywords	svn
how can I search an svn repository for the existance of files in any revision	svn
Subversion project structure?	svn
Best Subversion clients for Windows Vista (64bit)	svn
Proper way to move files to tags from trunk using svn?	svn
Best SVN Tools	svn
How can I have Subversion keep only the latest verison of a file?	svn
Tools for SVN Merging	svn
Get log details for a specific revision number in a post-commit hook with SharpSVN?	svn
SVN Server running on Windows Vista in a Home Network, Accessing from Mac OS X	svn
When using cvs2svn how can you rename symbols such that a branch and tag resolve to the same name?	svn
Using SVN to lock documents for editing and update notifications	svn
Change default author in local svn repo	svn
Can i run a script when i commit to subversion?	svn
Merging from branch to trunk with 'Merge range of revisions'	svn
getting new file added to subversion with updating whole folder	svn
How to use svn with beyond compare 3	svn
How do I improve Windows Subversion client update performance?	svn
Server side svn branch reintegrate	svn
How can I change the repository url using AnkhSVN 2.x	svn
WAMP - PHP shell_exec() problem	svn
Revert a whole directory in tortoise svn?	svn
Migrating svn 1.4 repo's to 1.6, populating node origins.	svn
What's an easy way to obtain the current svn revision in a c++ visual studio application	svn
Will an svn:external subdirectory sync with its HEAD revision upon every 'svn update' to the parent working copy?	svn
Is there any way to block files being committed to SVN repository	svn
It is possible to completely remove a file from my SVN repository?	svn
SVN problem: What is the latest revision that still contained this code snipped?	svn
Will creating a new folder break subversion?	svn
Subversion: Fail update when there are conflicts?	svn
Do you continue development in a branch or in the trunk?	svn
Recover files from old Subversion backup	svn
Checkout one file from subversion	svn
Configuring Subversion to use system users/passwords	svn
How does one manage multiple release branches in subversion?	svn
Using SharpSvn to retrieve log entries within a date range	svn
How to remove SVN from a folder	svn
Best practices for a single large SVN project.	svn
SVN Firefox Plugin	svn
[easy] SVN checkout with svn protocol	svn
Revovering from Subversion corruption	svn
Setting up SVN to Best Suit Dev -> QA -> Prod	svn
How do you treat legacy code (and data)?	svn
SVN automatic code formatting on check in?	svn
Better way to revert to a previous SVN revision of a file?	svn
SVN?  VSS?  Why is one better than the other?	svn
Subversion Branch/Trunk Best Practice - keeping Branch Up-to-Date?	svn
Tortoise SVN Move command fails	svn
detect svn changes in a .bat	svn
SVN - merge one branch into another?	svn
Best way to organize a subversion repository of many small projects	svn
SVN analysis tool	svn
Why am I getting tree conflicts in subversion?	svn
Having latest copy of SVN'ed files in document root	svn
Use SVN instead of CVS on SourceForge	svn
"How do I do ""svn st"" in AnkhSVN for Visual Studio? -no text-"	svn
What do the letter suffixes on SVN version numbers mean?	svn
Subversion: How to retrieve files changed in range of revisions?	svn
Is SVN 1.5 Merge-tracking ready for prime-time?	svn
TortoiseSVN can't connect to machine in workgroup	svn
Problem connecting to SVN repository	svn
how to branch code to another responsibility for SVN?	svn
Make SVN directory locally read-only	svn
Tortiose SVN Revisions	svn
Shelve in TortoiseSVN?	svn
How to use SVN, Branch? Tag? Trunk?	svn
Best way to track and enforce peer reviews before commit	svn
svnant - parent dir in server is not a working copy.	svn
Subversion: how to nuke a repository?	svn
SVN: Colleague checked in a folder into repository, but I can't Update my version to it	svn
What happens if I don't use the --Reintegrate option in Subversion 1.5?	svn
Handling conflicts in SVN with Tortoise?	svn
Automatically creating a tag in subversion	svn
creating patches between revisions per file	svn
Subversion as version-incrementor at each commit?	svn
When doing a tortoise svn merge, it includes a bunch of directories in the changes. Why?	svn
SVN backup	svn
Disabling the constant upgrade messages from subversion clients...	svn
svn:externals and permissions	svn
How to quarantine a specific subversion revision?	svn
How to export a part of SVN repository with dependencies?	svn
is it possible to migrate a single component from one svn repository to another while preserving history?	svn
How to update a web page without reloading the web page using AJAX?	ajax
JQuery Ajax Form and Dynamically created form elements not submitting	ajax
How to prevent IE6 from refetching already-fetched images added via DOM manipulation	ajax
prototype serialize returns function instead of serialized string	ajax
how to clear the textbox value of asyncfileupload .. ?	ajax
Any feeback on the lib Ajax-Cross-Domain and the Jquery patch  ?	ajax
Run db query (sql server 2005) with ajax. Is it possible?	ajax
Ajax Javascript show/hide works with JQuery 1.3.2 but not JQuery 1.4	ajax
Asp.net Ajax , Hangs Somtimes	ajax
Running a PHP through Ajax on Unload	ajax
Upload and Crop image	ajax
Adsense in a AJAX heavy webapp	ajax
HTML/Javascript app that runs on the filesystem, security issue	ajax
Html checkbox change value in MySql	ajax
How to have AJAX trigger the browser's loading	ajax
What would be the best place to start learning AJAX (I have Perl as a backend)	ajax
Best way to use jQuery's .ajax() function retrieve variables from a php script?	ajax
Ajax Cross Domain Calls	ajax
What exactly is the point of the ScriptManager's	ajax
Create  user folders like userfolder/ticket and manage on a server in c#	ajax
Handle www-authentication request using ajax?	ajax
Ajax Get +JQuery	ajax
Ajax onSuccess callback while not having any control over ajax calls	ajax
Functions too fast? So they get skipped?	ajax
My jquery ajax form will not post	ajax
ajax js serialize not reading form elements	ajax
how to disable submit button with ajax based on ajax response	ajax
How to use ajax with jquery on perl	ajax
Is there a list of AJAX JSF Libraries available?	ajax
Dynamic height for AJAX Autocomplete Textbox	ajax
Ajax Request Results in form being submitted aswell	ajax
How keep-alive of HTTP can/is play role in AJAX application	ajax
What's a good book for learning Ajax?	ajax
Progressive Enhancement	ajax
how to secure AJAX interface accepting GET requests.	ajax
Ajax-ish updating of a canvas element	ajax
How do I use AJAX to update a simple user control?	ajax
ajax call through cas	ajax
Browser continues 'loading' after ajax request finishes.	ajax
ColdFusion vs PHP	ajax
Scriptaculous Ajax.InPlaceEditor: How to trigger cancel action?	ajax
When you show and hide a div, will it re-adjust surrounding elements automagically?	ajax
What is the best way to bind a repeater to an AJAX response?	ajax
Ajax GET requests: use parameters or put data in URL?	ajax
AJAX page + SQL query behaving vaguely ?!	ajax
How do I switch external css files with ajax?	ajax
is it possible to change page before ajax?	ajax
Pass multiple arrays to javascript via ajax	ajax
Best Way to Ajax-Control Table Rows	ajax
Get result of a JS file directly? (sorta AJAX related)	ajax
jquery form plugin & programmatic submit	ajax
Is it possible to integrate javascript with flash/a java applet/some other plugin that can create a tcp connection?	ajax
What are the options available for cross platform rich user interfaces development?	ajax
google opensearch plugin ajax drop down	ajax
"AJAX leading to more ""chattiness"""	ajax
JQuery Ajax Post results in 500 Internal Server Error	ajax
Ajax autocomplete (or autosuggest) with TAB completion similar to shell command line completion?	ajax
Can I use XMLHttpRequest on a different port from a script file loaded from that port?	ajax
Some Paramters in $.ajax not passing	ajax
How to send js array via ajax?	ajax
Ajax update panel problem !!	ajax
Best way to implement realtime UI updates like SO's 'new answer' notifier?	ajax
ajax jquery webhosting question	ajax
Ajax and PHP help	ajax
JavaScript problem?	ajax
Postback or Callback?	ajax
Returning redirect as response to XHR request.	ajax
automatically processing contents of <textarea> without user pressing a button	ajax
Dangers of Ajax	ajax
Ajax Post method using jquery	ajax
"stackoverflow ""Related Questions"""	ajax
Loop doesnt work without alert() in ajax readystate()	ajax
Jquery Ajax loading form on asp.net webform	ajax
Code separation in AJAX applications	ajax
Problems using window.opener	ajax
ASP.Net ScriptControl - Add the Javascript get_events method : Possible?	ajax
Where can I find a large AJAX loader .gif?	ajax
Ajax dropdown limit to list	ajax
How to iterate headers of sys.net.webrequest (ajax)	ajax
Can someone please tell me what AJAX really is?	ajax
Best tools for AJAX	ajax
Send HTML through Ajax POST	ajax
Retrieving & Displaying data from csv files using AJAX	ajax
Updating ASP.NET label while processing	ajax
AJAX and how to best deal with it server side in PHP	ajax
AJAX load of a rendered PNG not working	ajax
Rendering HTML Content from AJAX result	ajax
Exception handling in Ajax Calls.	ajax
How to open a web page from QlikView?	ajax
"""browser back"" possible without reloading page (AJAX)"	ajax
Is a variable in javascript available after loading an iframe and then going back to the page?	ajax
RA-AJAX download anywhere?	ajax
Can you send dynamic data to a processing applet?	ajax
Ajax call not working in IE7 and FF.	ajax
Asp.NET Webpart > Userctrl > ClientScript.RegisterStartupScript not working!?	ajax
SecurityException when making ajax call from only a certain machine?	ajax
Using xsl:include with AJAX/XSLT	ajax
How to ensure AJAX encoding will work	ajax
Why am I stuck in this AJAX submit loop?	ajax
Ajax breaks frameset in IE only	ajax
Display Ajax Loader while page rendering	ajax
Ajax request parametors, what am I doign wrong?	ajax
IE hungs when more than 4 async requests are triggered with xmlhttprequest object	ajax
What is the difference between request by form submit and request by ajax?	ajax
how to scroll asp.net textbox to bottom	ajax
How to cancel ajax request that has run (on server side)	ajax
ajax displaying code instead of result	ajax
How to unload content from loaded div by AJAX	ajax
Ajax upatepanel on user control, parent's inline style not rendered by IE	ajax
Microsoft's AJAX Toolkit vs. Ajax	ajax
Wtf IE7 - AJAX calls using setTimeout	ajax
When to use Ajax vs Json for Javascript events?	ajax
Preventing an duplicate ajax events in jquery	ajax
A question about cross-domain (subdomain) ajax request.	ajax
"Ajax: Partial refresh of a parent page (update a div) from ""lightbox"" window"	ajax
AJAX chat, auto scroll window	ajax
How is AJAX implemented, and how does it help web dev?	ajax
"how do widgets like ""http://sharethis.com/"" make what seem to be XSS calls"	ajax
Is it possible to recreate IKEA's functionality using Ajax?	ajax
xml validity, ajax, and php	ajax
"Script puzzle <script src=""ajaxpage.php?emp_id=23"" /> ?"	ajax
Assigning random colors per session, for chat	ajax
Ajax project suggestion.	ajax
XMLHttpRequest object not being instantiated?	ajax
Ajax Tutorial	ajax
Should I bring HTML snippets or JSON?	ajax
Setting location.hash in frames.	ajax
Is more ajax better for resources on a web app?	ajax
ajax push server	ajax
Ajax and record ID's	ajax
AJAX - timed mySQL queries (please wait screen)	ajax
jquery script is using to much memory	ajax
How to Force Javascript to Execute within HTML Response to Ajax Request	ajax
Creating a web app, then adding AJAX to it?	ajax
How to use AJAX to populate state list depending on Country list?	ajax
Newbie: What does jQuery.ajaxSetup 'beforeSend' do?	ajax
Contact form using PHP and jQuery form plugin	ajax
Ajax request with JQuery on page unload	ajax
Downloading CSV via AJAX	ajax
Why are my property get_ and set_ not exposed in an AJAX Control?	ajax
MVC Ajax Begin form hides submit button on ajax call	ajax
creating a popupwindow from html, not a file	ajax
AJAX Frameworks for C#	ajax
"Creating a ""Breaking News"" div with ajax if file exists?"	ajax
How important do you think Progressive Enhancement is?	ajax
How can I add a hover class to an element?	ajax
Ajax instant messaging (web-based)	ajax
GET vs POST in ajax ?	ajax
Create editable new rows to a table	ajax
using ajax update panel for update progress	ajax
How can I put $HOME/opt/git/bin to my PATH?	bash
Why do processes spawned by cron end up defunct?	bash
How do I write a bash alias/function to grep all files in all subdirectories for a string?	bash
How to test if a given path is a mount point	bash
Handling metacharacters in search strings	bash
(less ugly way to) slice an array in bash	bash
bash rename files	bash
Problem redirecting a C program output in bash	bash
bash script to perform operation on each argument against the final argument	bash
Simple way to convert 00:20:40.28 (hours:minutes:seconds.split seconds) to seconds	bash
Bash insert a comma (,) after every third field of a variable or array?	bash
Literal quotes in flags for a command in a bash script	bash
Looping over commands to print and execute in BASH	bash
Set screen-title from shellscript	bash
How do I remove file suffix and path portion of a path string in Bash?	bash
Going backwards in a bash prompt	bash
"How do I write stderr to a file while using ""tee"" with a pipe?"	bash
cd doesn't work when redirecting output?	bash
how to escape white space in bash loop list	bash
Bash while loop calling a Python script	bash
How do i find my computer's ip address using the bash shell?	bash
How can I create a temp file with a specific extension in bash?	bash
alternate way to trigger reverse-i-search without pressing ctrl+r in bash	bash
Remove slash from the end of a variable	bash
redirecting standard output to the calling process	bash
Is there a convention for naming 'private functions' in bash?	bash
Real-time history export amongst bash terminal windows	bash
Using conditional statements inside 'expect'	bash
Bash script executting su command	bash
Recommended online resources for learning bash scripting	bash
Sequence expression in bash	bash
Automatically timing every executed command and show in Bash prompt?	bash
Processing a log to fix a malformed IP address ?.?.?.x	bash
How to retrieve the first word of the output of a command in bash?	bash
bash scripting..copying files without overwriting	bash
Bash script to find a file in directory tree and append it to another file	bash
What should a longtime Windows user know when starting to use Linux?	bash
How to ask bash to wait for a result and send a SIGKILL when it get it ?	bash
How to do a search? (bash)	bash
Run command when bash script is stopped	bash
Can I specify redirects and pipes in variables?	bash
Bash alias of an svn command piped to awk	bash
Passing BASH arguments	bash
How can I remove the first line of a text file using bash/sed script	bash
Unable to find release notes for Bash	bash
sed replace command inside of a bash script?	bash
Run bash script from Windows PowerShell	bash
Grabbing every 4th file	bash
How to send a SIGINT to Python from a bash script?	bash
Redirecting bash stdout/stderr to two places?	bash
PID of last started process in Bash-Script	bash
parsing a line in bash	bash
Passing a string with spaces as a function argument in bash	bash
Removing final bash script argument	bash
How can I program ksh93 to use bash autocompletion?	bash
BASH MySQL Query to Comma Separated File	bash
awk my number, im supid in bash	bash
BASH: error message does not get redirected to file	bash
Bash: Getting standard program for file type	bash
How can I select random files from a directory in bash?	bash
Batch Renaming with Bash	bash
Match URL link from input string	bash
Split line into words in bash	bash
Lookup shell variables by name, indirectly	bash
how to remove large amount of files using rm	bash
awk and printf in bash	bash
Remove first 4 letters from a folder name using bash scripting	bash
Updating live server from VCS	bash
Enviroment variable within variable	bash
how to check if a string has spaces in bash shell	bash
sed replace ' with \'	bash
How to delegate within a crontab to use another file as a crontab? aka Crontab in SVN/CVS?	bash
Issue with echo and tab in Bash	bash
Autocomplete for the ruby command in bash	bash
Use bash to read a file and then execute a command from the words extracted	bash
How to insert a new line character after a fixed number of characters in a file	bash
$$ in Bash.	bash
bash/sh single-quote, doublequote & backquote question	bash
Getting a 'source: not found' error when using source in a bash script	bash
A script to ssh into a remote folder and check all files?	bash
Auto confirm EULA in bash script	bash
bash script - select from database into variable	bash
Newline Madness in Bash Script	bash
How to grab live text from a URL?	bash
Check if a string contain Asterisk (*)	bash
Bash open Firefox Window, then each subsequent window in tabs	bash
Can you pass stdin into unix host/dig command?	bash
How to kill all asynchronous processes	bash
Bash for loop with wildcards and hidden files	bash
BASH scripts : whiptail file select	bash
Unable to move pictures from Desktop to a specifig folder	bash
What's the easiest way to colorize bash shell outputs?	bash
How to glob variables in bash script	bash
Delete all but the 4 newest directories	bash
"Minimal ""Task Queue"" with stock Linux tools to leverage Multicore CPU"	bash
awk without printing newline	bash
Getting the pid of a job launched in the background remotely	bash
For loop in Bash Script	bash
How to debug a bash script?	bash
How do I set environment variable completion in a bash shell on mac	bash
[bash] Check if a package is installed and then install it if it's not.	bash
Bash: how to traverse directory structure and execute commands?	bash
Removing created temp files in unexpected bash exit	bash
bash : how to use screen to have a term session used at home after work?	bash
Bash usage of vi or emacs	bash
bash history re-runs: possible command to avoid using !bang! ?	bash
"Grep with ""half""-exact match"	bash
Pass list of variables to bash script	bash
Undeletable file due to backup script	bash
Bash script for manual routes and default gateway problem	bash
How would you represent EOF in bash?	bash
bash and filenames with spaces	bash
Program Interaction and testing via bash script	bash
bash case statements evaluate to strings	bash
Bash plugin help: Auto insert closing bracet with cursor in middle	bash
environment path loading incorrectly in bash	bash
bash script execution date/time	bash
Improved technique to store a filename in a variable?	bash
zip columns from separate files together in bash	bash
Bash: Sleep until a specific time/date	bash
Bash+cron: Redirecting, and restoring, stdout and stderr produces permission denied	bash
Bash Script - Read Binary File	bash
Bash: Subprocess access variables	bash
Appened to /etc/apt/sources.list	bash
How do I create a directory on remote host if it doesn't exist without ssh-ing in?	bash
remove whitespace from bash variable	bash
YYYY-MM-DD format date in shell script	bash
bash errors in this script ?	bash
pipe many outputs to same file at the same time?	bash
Ending tail -f started in a shell script	bash
making graphs with a shell script	bash
Bash - Supress Notice of Forked Command Being Killed	bash
Testing for GUI in .bashrc	bash
Bash shell function error : command not found	bash
BASH: Test whether string is valid as an integer?	bash
See binary instead of hex in Binary file while in a shell like bash.	bash
How to get the IP address from $SSH_CLIENT	bash
How to set an alias inside a bash shell script	bash
How to enable command line switches?	bash
Substitution after the end of the word	bash
How to run every script in a directory except itself?	bash
How to sudo on a computer using ssh inside a bash script	bash
"How to get this bash script to work if the ""fileName"" contains space?"	bash
Escaping 'echo' in batch files	bash
How do I redirect stdin from a shell script to a command in the shell script?	bash
How do you append to an already existing string?	bash
Problems using git diff to create file list for deploy	bash
Escape < and > in sed/bash	bash
Hide a bash function internals..	bash
How to run processes piped with bash on multiple cores?	bash
Excel reading in ASP.NET : Data not being read if column has different data formats	excel
Excel function to determine the last Friday in a month	excel
How to select Interop .NET framwork version running from Excel?	excel
Format cell color based on value in another sheet and cell	excel
"Is it possible to ""link"" two cells in Excel via some sort of formula?"	excel
Excel: Cannot Delete Pesky Drop Down from Sheet	excel
Removing parts of a cell	excel
Excel VBA copy XL-2007 Macro-Enabled Workbook as excel-2003 file with no macros	excel
Excel form hides behind other windows after I browse for file but I want it to stay on top.	excel
deleting an excel file in C#, Taskmanager process is not stopped.....	excel
Accessing Excel data source running SSIS package on 64 bit server	excel
How Do I Loop Through An Excel Spreadsheet With VBA, Paste A Value To A Website Form Then Extract The Result Back?	excel
Copy/Paste from Excel to a web page	excel
generate excel sheet from a excel template in asp.net using vb.net	excel
Help me find the reg-key which is preventing me from chaning excel macro security-level?	excel
Extracting unicode text from Excel spreadsheet using VBA	excel
how to pass string array from C/C++ dll to vba (Excel)	excel
Please help me the macro that only a cell of the specific keyword does in a blank. in Excel	excel
How to create Linked texbox in worksheet?	excel
Exporting VBA code from Multiple Excel documents to put into version control	excel
Excel COM Add-In dialog interrupts script	excel
Excel addin development environment	excel
Excel: getting the selected rows back	excel
how to get Min and max in excel depending on another column?	excel
Get istance of Excel application with C# by Handle	excel
Export from Excel to text file without line breaks	excel
Error while generating a PDF file with Excel using C# in ASP.NET	excel
XLL plugin's DDEConnect fails when connecting to Excel?	excel
What in the best exel book for non-programmers?	excel
Programmatic positioning of VBA charts has stopped working	excel
What causes Error 70 in Excel VBA?	excel
How do I display a ratio in Excel in the format A:B?	excel
Excel, 2 sheets, 2 columns, same value?	excel
Excel Conditional formatting with weighted total	excel
Declcaring variables in Excel Cells	excel
Reference and filter data to other sheet in Excel	excel
Return background color of selected cell	excel
Automatically execute an excel macro on a cell changed by a real-time add-in	excel
Excel: How can I display the data from several sheets in one?	excel
Excel 2003 XML format - AutoFitWidth not working	excel
Is there a work around when hitting the maximum summands in =sum in an excel formula?	excel
Getting last insert id in Excel ADODB connection to MySQL database	excel
Convert image (jpg) to base64 in Excel VBA?	excel
Excel: How to display more information when using Subtotals?	excel
Excel: Set background colour of cell to rgb value of data in cell.	excel
Excel: need help with unusual lookup function (sorted column is different from lookup column)	excel
Cannot display measure variance in Excel pivot table	excel
How to capture worksheet being added through Copy/Paste in Excel VBA	excel
Excel dll for Microsoft.Office.Interop.Excel	excel
Excel: how to start macro recording from OLE	excel
Dynamic pathfinding in Excel import	excel
"""Pivot"" a table in Excel"	excel
Excel 2007 pivot tables - how to use calculated fields when connecting to a data cube?	excel
Activate Range, Allow Edit, Continue	excel
Excel to XMl in .NET3.5	excel
How to read Excel file in c# by connection string?	excel
how do i get a count of columns that contain data from excel	excel
How do I export from MySQL to an Excel file in my PHP site?	excel
Excel AddIn throwing an exception in designer code	excel
Excel Pivot table range reference	excel
VBSCRIPT: How do I copy all rows from 3 worksheets and merge rows that are unique in the first column?	excel
Problem in sending excel file as attachment using mail function in php?	excel
Top ten ordering in Excel based on complex team rules	excel
deleting rows containing listed numbers in excel	excel
looking for 'sed' like functionality in Excel	excel
Excel - How to persist function in column when row data is cut or deleted?	excel
VBA SQL Query Table Error problem	excel
Nested If Statements Returning zero if nothing entered in cell.	excel
Loop through PageField in OLAP Cube [PivotTable]	excel
Excel - Red Cross where a drop down list should be	excel
List files of certain pattern using Excel VBA	excel
Creating add-in for Excel using C#.	excel
Creating a sublist based on a second column in excel	excel
Reading values from an Excel File	excel
Totaling figures in .csv files using Excel	excel
Merge and Left Justify a Range of Rows in Excel	excel
Writing data back to SQL from Excel sheet	excel
Excel Add-in doesn't get the hint	excel
Case senstive validation in Excel from Named List	excel
How to get next IP in range from Excel	excel
How to suppress the file corrupt warning at excel download?	excel
Wrap rows in Excel	excel
Excel VBA Macro: Check content (of clipboard?) before pasting	excel
Zip Code distance in excel	excel
Getting Valuue from MS Access form from Excel VBA.	excel
Excel 2002 Add-In not loading when the application opens	excel
How to convert a DB2 date-time string into an Excel Date	excel
What is the correct excel formula?	excel
How to insert programmatically a new line in an Excel cell in C#?	excel
How can I autofill cells in Excel?	excel
Exporting data to excel	excel
Determining wrong input file using VBA & Excel	excel
Find distance between two cities in Excel using Google Maps API	excel
Reinitilise a range in Excel / VBA	excel
Making Excel macro for fast data entering ::: VBA ::: Excel :::	excel
Exporting Excel cell data to database via Excel macro?	excel
Unable to access Excel's Application.ComAddIns property if there are no AddIns installed	excel
Excel / Quickbooks data to c#	excel
Find the differences between 2 excel worksheets?	excel
Is is possible to insert an image into an excel cell via COM?	excel
trouble connecting Excel to Analysis Services server..	excel
Excel built-in dialogs	excel
Export to Excel from a Repeater?	excel
Calling an Excel Add-In method from C# application or vice versa	excel
how to get such results using excel formula	excel
How can you make Game of life in Excel?	excel
What are the (gotchas and) limitations when using POI to create Excel workbooks?	excel
How to avoid Excel localizing object names and breaking macros?	excel
Excel VBA: Help with deleting cells based on conditions	excel
Need skeleton code to call Excel VBA from PythonWin	excel
How do you typically import data from a spreadsheet to multiple database columns?	excel
insert row keeping formula in excel	excel
Excel document recovery	excel
Default value for PivotChart Report Filter/Page Field	excel
Excel 2000 VBA: Errors Raised within Class Debug As If Raised at Property Call	excel
How to tell if an Excel Workbook is protected	excel
SQLite data into Excel?	excel
Excel Vs C# Number Differences	excel
"How do I reference a ""subset"" or cells in an Excel Named Range?"	excel
excel - how to duplicate each row with a macro	excel
Will upgrading Office from 2003 to 2007 break VB programs which use Excel through the COM interop?	excel
Working out which cell Vlookup refers to	excel
Manupulating Excel files from Windows Scripting Host	excel
How do I find the Excel column name that corresponds to a given integer?	excel
collate 500 excel sheets into database	excel
"How to run a Windows 2008 task from the scheduler with ""interact with desktop"""	excel
Excel VBA pastelink run-time error 1004: Application-defined or object-defined error.	excel
Retain cell address when sorting list	excel
Multiple select Listbox in Excel for an import sheet	excel
ODBC connect with propritary driver/Excel Trust settings	excel
Can Excel use itself as an RDBMS?	excel
MSExcel 2002 calling Web Services.	excel
No error message available, result code: E_FAIL(0x80004005)	excel
Excel CSV - Number cell format	excel
ADODB.Connection undefined	excel
Print certain tabs	excel
COM Automation / Running Excel Macros	excel
Excel VBA Application.OnTime.  I think its a bad idea to use this... thoughts either way?	excel
Excel pivot chart linear time-scale	excel
Where can I find documentation for Excel's Pictures collection?	excel
Protect excel file with java	excel
Return empty cell from formula in Excel	excel
Excel column names	excel
Convert content from excel cells from string duration to number of minutes	excel
How to edit my excel dropdown list ?	excel
Looping Variable Names	excel
Non-Sequential Range	excel
excel group with hidden rows	excel
Use Excel Interop to grab image of Excel chart without writing to disk or using the clipboard	excel
How do I use a parameter in an Excel external data request?	excel
linq nested query using .contains with a bigint	linq
LINQ - Help me grasp it with an example I think LINQ should be able to solve!	linq
The || (or) Operator in Linq with C#	linq
Grouping by Time ranges in Linq	linq
VerificationException Operation could destabilize the runtime on Simple LINQ Query	linq
Linq Caveats	linq
When to use lambda expressions instead of a Where clause in LINQ	linq
VB.Net Linq - How to append a where clause?	linq
C# Linq Group By issue, probably really easy!	linq
How to get position inside a select statement	linq
Multiple WHERE clause in Linq	linq
Expression.Invoke in Entity Framework?	linq
How do you guard for Null Reference exceptions in Linq To Xml?	linq
Create XML using Linq to XML and arrays	linq
Help required to optimize LINQ query	linq
NullReferenceException when using Linq to XML	linq
Problems with LINQ	linq
Are LINQ expression trees Turing complete?	linq
In what scenarios is LINQ best applicable?	linq
Linq returning list of anonymous types	linq
Beginner LINQ question	linq
How to use the System.LINQ.Dynamic assembly w/ IEnumerable(Of T)	linq
linq - how do you do a query for items in one query source that are not in another one?	linq
LINQ: Using AssociateWith and Distinct together	linq
My O/R Designer keeps deleting the designer.cs file!	linq
Timesheets: Retrieve data using SQL, LINQ or class?	linq
Serilializing Linq.Table to XML	linq
LINQ default methods for insert/delete/update are coming disabled in visual studio 2008	linq
LINQ, iterators, selecting and projection	linq
Linq to SQL Nested IN FROM query	linq
Using Linq SubmitChanges without TimeStamp and StoredProcedures the same time	linq
Working with Anonymous Types with Linq in VB, C#	linq
LINQ GroupJoin innerKeySelector/outerKeySeletor issue with two DataTables	linq
join query with linq	linq
Changing a LINQ objects data context	linq
How do I write this in Ruby/Python? Or, can you translate my LINQ to Ruby/Python?	linq
Linq remove elements from one collection into another collection	linq
LinqtoSQL filter and order by syntax	linq
LINQ-to-SQL and mass-changes submit very slow	linq
linqtosql, timespan, aggregates ... can it be done?	linq
Linq output as an Interface?	linq
Linq (MIN && MAX)	linq
LINQ Error Invalid Column Name on Group by sum.	linq
LINQ asp.net page against MS Access . .	linq
How does coding with Linq work? What happens behind the scenes?	linq
Discrepancies between â€œMockâ€ Database and â€œRealâ€ database behaviours.	linq
IDictionary is Linq friendly? C# 3.0	linq
Writing SQL function with XQuery Parameters	linq
LINQ - Update null integer data field	linq
.NET Linq Join	linq
How to force Linq to update last edit time of a row?	linq
Generic Linq ordering function?	linq
efficient way to make paging on sql server 2008	linq
Search for whole word with Linq to SQL	linq
Linq Expresion Tree	linq
linq question: querying nested collections	linq
Conditional Multiple Fields Searching and Filtering in LINQ	linq
Linq: What is the difference between Select and Where	linq
Stop Linq To Sql from Renaming properties of the DataContext after I rename them	linq
Timespan to string problem in LINQ query	linq
DataContxet reusing connection	linq
Can take be used in query expressions in c# linq?	linq
Linq select * with multiple tables	linq
LinqToEntities not retrieving child objects of an entity	linq
LINQ to Objects question	linq
Object reference not set to an instance of object error	linq
Group by Question in Linq	linq
LINQ Optimization Question	linq
How do you add an index field to Linq results	linq
Modifying the sort order of a LINQ query	linq
How to write this as a single LINQ query	linq
How do I delete records from a child collection in LINQ to SQL?	linq
Conditional LINQ where statement?	linq
High performance product catalog in asp.net?	linq
How to create a dynamic Linq Join extension method	linq
LINQ  to XML question	linq
LINQ: Remove items from IQueryable	linq
Is there a quick way to say If notempty x = y else x = default in a Linq where query	linq
LINQ to SQL Insert Sequential GUID	linq
Linq to XML Noob question - distinct and order by on attributes	linq
How to select only Date value No Time in LINQ to SQL?	linq
How To add another constructor with parameter in linq class(Table)	linq
Linq to Sql - Set connection string dynamically based on environment variable	linq
Linq, VB - Anonymous type cannot be converted to anonymous type.	linq
My linq-query doesn't work when adding the xmlns-attribute to the root-element in my XML-document	linq
Get a random row with LINQToSQL	linq
Resources for learning LINQ?	linq
Linq Stored Procedure Issue	linq
linq group by a start time to endtime on DateTime Column	linq
LINQ - Select correct values from nested collection	linq
Run a method on all objects within a collection	linq
Get Directory Structure using Linq?	linq
"When does a library deserve the be called ""Linq-something"" or ""something-Linq""?"	linq
Linq To SQL caching VS multi-user application.	linq
Restrict LINQ Subquery when databound to a grid	linq
Query an XDocument for elements by name at any depth	linq
Out to merge a collection of collections in Linq	linq
issue with submitChanges() inserting unwanted records in linq	linq
Strange Exception thrown using Dynamic Linq Entity Framework Query	linq
Linq with Left Join on SubQuery containing Count	linq
Linq equivalent of foreach	linq
Lambda Expression of Select * from TableName	linq
JOIN and LEFT JOIN equivalent in LINQ	linq
drawbacks of linq	linq
What OR/M tool that supports Linq/Iqueryable would you recommend?	linq
Linq validation non nullable properties	linq
Is there a way to capture the index value in a LINQ Where method in C#?	linq
Linq query on the maximum value of 2 fields	linq
how group by in Linq with 2 Field ?	linq
Extracting text from an IEnumerable<T>	linq
LINQ distinct join query	linq
Linq Methods	linq
Custom Linq Ordering	linq
What are Expression Trees in LINQ?	linq
LINQ Query skips without exception. Why?	linq
Can I acheive this with linq instead of For Each?	linq
Stop Linq2SQL using Named Pipes?	linq
LINQ to SQL - Update to increment a non-primary-key field - thread-safe	linq
Setting LinqDataSource bound DropDownList using URL querystring	linq
Can you reverse a string in one line with LINQ or a LAMBDA expression	linq
Fastest way to count number of uppercase characters in c#	linq
Linq: using StringComparer with GroupBy/Distinct in comprehension syntax	linq
How can I give alternative names to new objects created by LINQ?	linq
Linq/XML: grouping results properly within XML element - with inner joins!	linq
Passing a anonymous type to function.	linq
LINQ to SQL Designer Bug	linq
Is LinqToSQL the same as Linq?	linq
LinqToSQl and the  Member access not legal on type exception	linq
How do I stop the linq designer overwriting my manual changes?	linq
How do I tell LINQ to ignore attributes that don't exist?	linq
Is there a better way to get sub-sequences where each item matches a predicate?	linq
How do you handle arbitrary namespaces when querying over Linq to XML?	linq
Getting started using Linq, what do I need?	linq
Linq query to include a subtype	linq
How can I make a LINQ query with subqueries in the from statement?	linq
Using Linq with WCF	linq
How to update a single column in LINQ without loading the entire row?	linq
LINQ to SQL bug (or very strange feature) when using IQueryable, foreach, and multiple Where	linq
Can I declare a Global Inferred variable in C#?	linq
Hiw to bind LINQ data to dropdownlist	linq
Need some help ordering a Linq result.	linq
Null value cannot be assigned - LINQ query question	linq
How to use Linq to group every N number of rows	linq
Duplicate Rows when Data Binding with LINQ to Entities	linq
Single linq query for complex data structure : Dict<int, Dict<str, _class>>	linq
Linq Extension methods vs Linq syntax	linq
linq 'range variable' problem	linq
Overlay/Join two collections with Linq	linq
What are the names given to these 2 LINQ expressions	linq
LINQ Distinct operator ignore case?	linq
how can I find out why a custom widget isn't showing up in the Qt Designer?	qt
How do I read the windows registry (Default) value using QSettings?	qt
Using items in the background of a QGraphicsScene	qt
Set a custom icon for a QAction when disabled	qt
PCSC-Lite Codes on Windows	qt
Qt QTabWidget icon problem	qt
Better way of calling a function in child thread in Qt?	qt
Why does Qt add more than three columns when I use restoreState() on a QTableWidget?	qt
find if qtreewidgetitem is top level	qt
Model - View - Controler in Qt	qt
Qt library destructor Question	qt
How do I specifiy an object directory in a QT project file?	qt
In a QTableWidget, changing the text color of the selected row	qt
In Qt, how do I use Q_OBJECT slots and signals with multiple inheritance?	qt
qt - qprocess start in a loop	qt
How to maintain widgets aspect ratio in Qt?	qt
Missing file [Qt]	qt
Performance issue with QGraphicsScene::createItemGroup	qt
How to wait main application thread till worker thread complete in QT	qt
Qt signals and slots - are they intended for GUI only or for entire app architecture?	qt
Runtime-dynamic properties in QPropertyEditor	qt
How do I extract the angle of rotation from a QTransform?	qt
Qt: How to show icon when item selected	qt
Porting threads from QT3 to QT4	qt
Qt Python : QTreeWidget Child Problem	qt
Adding a Custom Widget to Qt Designer	qt
c++ for loop vs foreach	qt
Easily Creating Dynamic Form/Controls Within Qt	qt
Show Editors for All Cells in Row in QTableView	qt
Debugging QList<double> in Visual Studio with Qt integration	qt
adding  #ifndef  #define  #endif breaks the compile	qt
How to prevent libQtGui.so and libQtCore.so from being linked to a simple library built with qmake	qt
Does the use of styleSheet in a dynamic manner add alot of computation	qt
OpenCV, Nokia and QT - Will it work?	qt
qt/wxwidgets third party components?	qt
How to build QTcore4.dll without dependency to MSVCx80.dll?	qt
Qmake project dependencies (linked libraries)	qt
In QT, how to have a fixed size for QDialog	qt
Ss it possible to use CIN and QT ???	qt
Capture Qt widget as an image file	qt
Printing dialog or window with Qt	qt
Why QtCreator doesn't use QtPlugin?	qt
QMutex stuck in locked state	qt
Hardcoded QMAKESPEC in Qt Creator?	qt
QtScript: how to reload current script?	qt
qt python : combo-box bug behavior?	qt
Qt - top level widget with keyboard and mouse event transparency?	qt
Is QImage able to open and render pure 16-bit images?	qt
Auto-hide panel in QT or WxWidgets	qt
How to convert QWidget 's image format from ARGB32_PreMultiplied to ARGB32 ?	qt
Keyboard and mouse event transparent widget	qt
How to force QDateTime::fromString to read UTC time.	qt
Qt painted content goes lost	qt
I want to start Qt development - what basic knoledge in C++ and OS I have to own?	qt
problem filtering mousePressEvent with installEventFilter	qt
Reducing WAV sound file size, without loosing quality	qt
Qt Jambi: QAbstractListModel not displaying in QListView	qt
Two shortcuts for a QAbstractButton	qt
Simplest build of QMYSQL3	qt
Getting QMake to generate a proper .app	qt
issue with QT slider signal/gui	qt
Qt linguist & google translate	qt
Is it necessary for Qt::paintEvent to be reentrant?	qt
QGraphicsView accepted events	qt
Keep QPixmap copy of screen contents using X11, XDamage, XRender, and other tricks.	qt
Qt Creator: â€œinline function used but never definedâ€ â€“ why?	qt
Auto close QMessageBox	qt
unable to bind a signal to a slot in QT	qt
"Qt ""connect"" syntax is very long. Is it any tricks to make it shorter?"	qt
PyQt custom widget in c++	qt
Qt conflicting with GLee	qt
Creating Qt models for tree views	qt
How to set the line where a QToolBar is displayed?	qt
What rendering API does Qt use on Windows?	qt
QProgressbar and QNetworkReply signals	qt
qt/c++ casting question	qt
QT QImage pixel manipulation problems	qt
python Qt: main widget scroll bar	qt
Using QFileSystemModel in a QCompleter	qt
Identifier for win64 configuration in Qmake	qt
Naming convention for Qt widgets	qt
Building Opensource QT for Visual Studio 2005/2008	qt
How to text proximity to QGraphicsPathItem?	qt
Qt Widget Overlays	qt
Qt: Session Management Error	qt
Custom/Owner draw control in PyQt?	qt
how do i get a checkbox item from a QTableView and QStandardItemModel alone?	qt
Trouble using Qt with Visual Studio	qt
Qt: QImage always saves transparent color as black.	qt
QT: Using QPainter on child widgets	qt
QT 4.5 - how do I perform a queued connection with a template type?	qt
Qt and Sqlite examples	qt
or is not valid C++ : why does this code compile ?	qt
Wait until QWidget closes	qt
QT: meaning of slot return value?	qt
Invoking context menu in QTreeWidget	qt
Qt Visual Studio 2008 Add-in problem	qt
QGraphicsItem unselect redraw problem	qt
Can you install Qt-4.6.0-wince successfully?	qt
Qt, text on a black and white screen	qt
Qt: doesn't cause memory leak?	qt
How can I prevent dragged items to be drawn during a drag and drop operation in Qt?	qt
QT: reject() closing whole app? Why?	qt
stereo in QT using Open GL	qt
"Can I write programs in Qt and sell them as ""closed sourced""?"	qt
Can you create a setup.exe in qt to install your app on a client computer	qt
Automatically sorting on insert in QTreeWidget	qt
Qt Dialog Window Opens in Same Window	qt
QT Eclipse Integration - Adding External Libs	qt
How can I autoexpand an item in a QTreeView when it is filtered by QSortFilterProxyModel?	qt
Compiling a shared library with QT on Ubuntu 9.10	qt
qsettings different results	qt
What features in Qt do you like the most?	qt
What's the best strategy for large amounts of audio files in mobile application?	qt
Which way to go in Linux (Qt or KDevelop)	qt
Real time video capture??	qt
QtWebKit Manager	qt
Qt moc_ include file problem	qt
How to receive drag and drop from Apple Address book in Qt 4.4 on Mac OS X 10.5/10.6	qt
Weird Qt bug (to do with properties editor)	qt
Qt, Signals without naming?	qt
How to add widgets in runtime? (Qt)	qt
Changing terminalinterface command after showing it on qt/kdelibs app	qt
Q_Object with no type...	qt
Qt Python: QTextEdit - display input	qt
qt GUI connecting	qt
What advantages does  C++ have over other languages for Qt development?	qt
Using QFrame to display different panes of information?	qt
Catching a drag exit in Qt?	qt
How do windows work in qt embedded?	qt
How to deploy my application using Qt-Creator?	qt
Can a class inherited from Qthread behave as a normal class?	qt
Notifying subclass of QAbstractItemModel about changes	qt
Checking if a folder exists (and creating folders) in Qt, C++	qt
Qt Styles: How to style a widget that uses a .ui generated class?	qt
Saving QList<T> to a file?	qt
If I use QT For Windows, will my application run great on Linux/Mac/Windows?	qt
'Magical' QTextEdit size	qt
"In Windows, what makes qmake append ""d"" on a debug target?"	qt
Unique random number sequence using qrand() and qsrand()	qt
How do I make tab control take over entire window in Qt Creator?	qt
Generate vector EMF/WMF (Windows Metafile) clipboard content from Qt 4.5	qt
How do I ensure that I am dynamically linking my application to the Qt framework in Qt Creator?	qt
How to design an IDE using Qt?	qt
Qt question to fullscreen flash application	qt
Including a library in Qt, why isn't this working?	qt
Decrease Qt GUI application size	qt
How to control the position of QDialog	qt
How to Add this functionality to Qt 4.6 embedded linux QWS ( Qt Windowing System) ?	qt
Qt Custom Window	qt
Any way to rename image filenames?	drupal
'on the web' drupal module showing images on localhost but not remote host	drupal
Drupal 7 programming advancements, differences from Drupal 6 upgrade or wait	drupal
"DRUPAL: order exposed filter items, be carefully it is not that simple (I cannot user ""Sort"")"	drupal
Drupal CCK Field Level Visibility	drupal
is there an argument to know you're on a views list page?	drupal
Customize the theme output for the search box in Drupal	drupal
Very large drupal page execution time	drupal
Differing Apache Solr results when doing queries through Drupal â€“ why?	drupal
Drupal - open node body in new window	drupal
problem with Search module in drupal	drupal
DRUPAL: tags for CCK fields ?	drupal
How do I upgrade from Drupal 5 to 6?	drupal
Can I develop a Mobile website using Drupal?	drupal
Drupal Templating/Theming Resources or Advice?	drupal
Drupal : How to add javascript function on click event of a cck check box ?	drupal
Drupal 6: onkeyup event to a custom form field	drupal
a link to parent node in nodecomments in drupal 6	drupal
How to allow customization of a platform built on Drupal (and PHP obfuscation)	drupal
Drupal: Different output for first item in a block	drupal
"Drupal is unable to create the ""files"" folder (and any upload php script as well)"	drupal
displaying a Drupal view without a page template around it	drupal
Drupal API: how to load a module dependency from another module	drupal
setting page access permissions in drupal	drupal
hardening drupal for a  live deployment	drupal
Add link to calendar page in Drupal	drupal
Drupal - editing tab options for a content type not showing up	drupal
Accessing user profile variables	drupal
Change the order of the 'Search this site' form in Drupal	drupal
Views/Flags relationship-argument puzzle	drupal
Cant find the Error in this Php piece of code	drupal
CCK field prefixes?	drupal
Drupal: customizing user registration workflow for communicating with another webapp	drupal
Drupal and Ubercart - Add order that customer can pay for online? Bill customer's order without having them manually put it in their cart?	drupal
How to create Wordpress-style widgets in Drupal	drupal
DRUPAL: combine CCK image and videos in a common ordered list. Possible ?	drupal
When to develop a new drupal module vs. work with what exists?	drupal
Views in Drupal: ignore arguments	drupal
Drupal 6: form_state values empty on submit	drupal
How can use the currently displayed node to filter a block-level view on that node's page?	drupal
Drupal Views: How to a print the last time a View cache was refreshed to the view Display	drupal
Drupal - How can I use CCK to keep a local node copy of Aggregator items?	drupal
Drupal 6: redirect Modules	drupal
does it worth to use MYSQLI_CLIENT_COMPRESS when the db is on another machine ?	drupal
Drupal 6 devel module dd() function not writing to drupal_debug.txt file	drupal
Loading users from an SQL query - the correct way	drupal
Drupal node?destination not working	drupal
Please suggest a good book on Drupal	drupal
Drupal tagging via tagadelic	drupal
Google Adsense doesn't work with Drupal	drupal
drupal menu item not active	drupal
drupal views: how to create a web form for each user	drupal
Drupal views require_once	drupal
Drupal + LightBox2 component = use body as title (caption) for lightbox	drupal
Drupal module span classes	drupal
Drupal theme_jcalendar_view	drupal
Node titles as menu items in drupal	drupal
How to display only taxonomy terms with nodes associated to in Views 2?	drupal
What is the best Drupal Survey module	drupal
Drupal linking a Username to a Node	drupal
Drupal: Varnish and cookies	drupal
CSS Layout not working in IE7 (all other browsers are fine)	drupal
Can you call one Drupal views template for multiple views?	drupal
How to merge Drupal database changes	drupal
Creating a login based website in Drupal	drupal
Download attachments in one file	drupal
But I still need to know how to show user e-mail in Drupal 5.x profile (nodeprofile)?	drupal
drupal's hook_preprocess_page not working as expected	drupal
Drupal allow anonymous comments	drupal
Drupal page optimization question... which is better?	drupal
Drupal forms with WYSIWYG and AHAH	drupal
Drupal nested subform	drupal
most read pages - drupal	drupal
Drupal: How to theme a module	drupal
Feedback form on Drupal 6 CCK content type	drupal
How to paginate Views page display?	drupal
Drupal Multi-Module Combinations for Cool Effects	drupal
How to display the query executed by the drupal view	drupal
Views doesn't show checkbox fields where answer > 1	drupal
Convert database from Antislaed to Drupal	drupal
Filter and View screens on different pages	drupal
Drupal combined user+content search	drupal
Where is a good guide for Drupal themeing?	drupal
Getting error when trying to save CCK text fields in Drupal.	drupal
grouping nodes in drupal with taxonomy	drupal
drupal > views > exposed filter > submit on change	drupal
PreMade Webdesign and Drupal	drupal
Drupal: Enable search form globally?	drupal
Drupal 6: Modifying uid of a submitted node	drupal
Drupal theme preprocess function - primary links	drupal
"Drupal 6: How can I ""turn off"" a page?"	drupal
Good beginners material/advice on Drupal	drupal
Drupal: How to retrieve parent page's $node variable in a block using module_invoke()?	drupal
Drupal: retrieve data from multiple node types in views 2?	drupal
using BC dates in Drupal date field	drupal
adding id to unordered list in views	drupal
Drupal 6 - Views2 - How to build a view of non-nodes	drupal
drupal bootstrap script: how to get list of all nodes of type x?	drupal
Is OpenAtrium really slow?	drupal
Drupal Form API and $form_state['storage'] is destroyed on a page refresh	drupal
More required for Selling Videos, E-book, Softwares using Drupal 6x	drupal
DRUPAL: Views, exposed filter: how to unselect all items as default	drupal
Printing $node vars in page.tpl.php	drupal
To use or not to use the user module	drupal
Drupal: Display success/error message	drupal
Adding HTML to Drupal closure?	drupal
Why does the '#weight' property sometimes not have any effect in Drupal forms?	drupal
Drupal Custom Menu Positioning	drupal
Drupal best practises for custom admin section	drupal
How to add theme settings to Zen-based themes?	drupal
Improving Drupal development with Extreme Programming practices	drupal
Drupal 5: Posting query string variables to a module page - Page not found	drupal
how to add additional message in a Drupal form	drupal
Drupal site front page	drupal
Theming CCK node in Drupal 5	drupal
where does drupal store the actual content in the database?	drupal
Include OpenId in drupal	drupal
Facebook module for Drupal 6	drupal
Connecting nodes to specific dates	drupal
Unique id on the 'a' tag of a menu item in Drupal	drupal
Drupal language negotiation	drupal
Drupal node selector strategy?	drupal
Drupal View display - setting a limit for the query results	drupal
Drupal / Htaccess: Rewriting specific URL	drupal
How do I authorize users on Telligent Community Server 2008.05 into another site?	drupal
Drupal: How to show specific view in a particular block	drupal
Is info about Drupal RSS signups available?	drupal
grouping items in a view	drupal
Can StackOverflow Help with My Drupal Design	drupal
Importing content from one/two Drupal installs into a fresh Drupal install	drupal
Multiple environment (Development, Staging, Live) in Drupal	drupal
how can I best display a list of affiliate links in Drupal?	drupal
how to organize my menu, taxonomy, views, pages in drupal 6	drupal
drupal: hide single taxonomy term in particular view display	drupal
How to restrict drupal search from indexing all content types?	drupal
Drupal path problem - views vs node	drupal
Drupal: how to change taxonomy header on page with items?	drupal
drupal redirecting api	drupal
Translate a Field's Label in a Drupal Content Type	drupal
Drupal onChange auto populate another CCK select list	drupal
Can I Omit <?php drupal_render($form); ?>	drupal
Date Popup module - I want a Time Popup as well	drupal
How to build a multilingual Drupal site?	drupal
How to rewrite part of the url with .htaccess?	drupal
How to theme a node differently depending on being inside nodereference	drupal
A metaphor for Drupal module's inner workings	drupal
Merge 2 views in Drupal - using filters?	drupal
Drupal Module Add Menu Item To Primary Links?	drupal
What's best Drupal deployment strategy?	drupal
Drupal update.php produces error	drupal
System.Net.WebClient request gets 403 Forbidden but browsers do not with Apache servers	apache
htaccess rewrite	apache
mod_rewrite Rule to Cover All Domains	apache
Apache Ignores SSLRequire Directive	apache
How to configure Apache to proxy exactly one file?	apache
How do you configure Apache on Windows for SSL?	apache
Why use Apache over NGINX/Cherokee/Lighttpd?	apache
Why does this mod_rewrite expression not append the existing query string correctly?	apache
Apache mod_rewrite and PHP ?argument=something	apache
Is there a way to force apache to return 404 instead of 403?	apache
Can I serve a ClickOnce application with Apache?	apache
How to find the culprit module or script on huge Apache/PHP resident memory usage ?	apache
Apache resource usage	apache
Apache FOP: Displaying UTF-8 Characters in PDF (without embed?)	apache
Using Apache's mod_auth across multiple sub-domains for single sign-on?	apache
Apache on WIndows - growing VM Size of httpd.exe	apache
Multiple domains for one site: alias or redirect?	apache
Top & httpd - demystifying what is actually running	apache
Make Apache wait longer before delivering HTTP 408 request timeout	apache
suPHP upgrade causing 500 internal server error	apache
WebServicice with Apache CXF and custom headers.	apache
"Apache is incorrectly converting jsp pages to ""text/plain"""	apache
Clean URL Redirect Loop	apache
Getting ASN.1 Issuer strings from PEM files?	apache
Why is Apache mod_rewrite not behaving as expected	apache
How do I generate an SSL Certificate with Microsoft Certificate Services and then install / configure it to work with Apache?	apache
Do I need to send a 404?	apache
Who are using all the memory on my production server(apache + mysql + rails) ?	apache
htaccess redirect problem	apache
Making apache 2.2.11 parse .wml files as PHP?	apache
start php, apache?	apache
RHEL/Apache ssl.conf configuration problem	apache
Restrict Apache to only allow access using SSL for some directories	apache
Digester: Extracting node name	apache
How to timestamp request logs with millisecond accuracy in Apache 2.0	apache
Why won't my local Apache open html pages?	apache
How to serve PHP dynamic images efficiently on a LAMP server?	apache
mod_rewrite: periods from URI gone in the query string	apache
Passing CGI arguments to an executable in Apache on Windows	apache
Using Apache proxy to foward traffic to tinyproxy	apache
WSDL2Java tool error Apache CXF	apache
Rails page caching with Apache and capistrano	apache
How URL rewriting work?	apache
Apache2 isn't serving index.php	apache
Apache Caching within diffrent VirtualHosts	apache
Need help on Apache htaccess redirect rule	apache
How do I redirect to my same URL without getting a too many redirects error?	apache
How to keep a text file readable just from php and python, and not by users?	apache
Can I turn off an Apache Directive then turn it on in an include?	apache
Apache returns sitemap.xml not /sitemap	apache
Using ProxyPass for pages but not images	apache
How do I change which version of python mod_python uses	apache
Programmable transparent forward proxy	apache
Apache Django Mod_Wsgi Sessions Development Enviroment	apache
Hide directories from listing, but don't disable directory listings.	apache
Run index.php rather than listing files	apache
"Direct ""puts"" in Rails, to Apache log"	apache
RewriteRule to disregard a url variable	apache
Impose access limits from Apache to prevent scraping ?	apache
Wordpress Rewrite Redirect Failure	apache
how to achieve this in Apache?	apache
Apache worker MPM and Linux threads	apache
How to use apache mod_rewrite and alias at the same time?	apache
logging time using httpd.conf	apache
Apache 2.2 ignoring VirtualDocumentRoot VirtualHosts?	apache
Apache using Python 2.4, Python 2.5 scripts failing	apache
Getting Apache to execute command on every page view	apache
add a server alias to the domain's VHOST?	apache
How to redirect different sub domain requests to different port	apache
Using Apache mod_rewrite to remove sub-directories from URL	apache
Compressing HTTP request with LWP, Apache, and mod_deflate	apache
JMeter command line - linux version vs windows version	apache
Apache Webserver security and optimization tips	apache
how to handle PermGen space exception in Apache	apache
Apache, IIS... Server Explanation for a newbie	apache
Debugging problems shutting down Apache Tomcat	apache
Too many TIME_WAIT connections	apache
serve with apache all paths under a domain through one script.	apache
Apache URL Redirect	apache
How can I block mp3 crawlers from my website under Apache?	apache
Apache Integration with Lisp like web language	apache
Apace mod_rewrite redirect to internal server	apache
Apache/nginx fine grained (per file) permissions?	apache
cakephp & httpd.conf issues on windows based apache server (wamp)	apache
newly installed apache serving html content as text	apache
Error while loading FastCGI module in apache 2.2	apache
APACHE-TOMCAT can anybody elaborate which one is web-server and web-container?	apache
Apache RewriteCond from result of php request	apache
Apache .htaccess file redirect	apache
FastCGI cleanup code does not work under windows	apache
What does Apache need to support both mysqli and PDO?	apache
Redirect certain requests if referer not from same page?	apache
HTTPS on Apache; Will it show Apache?	apache
Apache - authorising a user in multiple groups	apache
Python interface to the Apache scoreboard (for server statistics)?	apache
Using Apache for load balancing routing	apache
Can mod_rewrite convert any number of parameters with any names?	apache
Apache not loading Xdebug, but does when started from the Command Line	apache
Apache Config - Exclude Subdirectories	apache
Redirecting an internal path to a virtual host	apache
Should mod_proxy_ajp or mod_jk be used for a production environment?	apache
Cannot get started with mod_rewrite	apache
Redirection to different port for different sub domain failed	apache
Apache CGI redirect to absolute URI doesn't work	apache
Is a destructor the right place to mark the end of a script's execution?	apache
Apache Alias problem, Snow Leopard	apache
How to enable mod_rewrite for Apache 2.2	apache
Having a CGI script catch all requests to a domain with Apache.	apache
How do I configure Apache to forward some URLs to my servlet container regardless if the file exists.	apache
HOWTO: rewrite requests for images, css and js to different folders for each application?	apache
Same rules for multiple directories in Apache?	apache
Apache shutting down unexpectedly	apache
PHP Server settings causing problem	apache
How do I restore Apache and PHP to Leopard defaults?	apache
What are the ways to run a server side script forever?	apache
Apache sub-sites	apache
Are these lines an error or info in Apache's error log?	apache
htcaccess - ModRewrite	apache
How to add additional headers to 302 redirects in Apache?	apache
Apache automatically restarting itself every couple of requests	apache
Setting up a basic web proxy in apache?	apache
How do I serve a script with apache instead of running it?	apache
Disable Trinidad skins	apache
Nesting Apache Tiles Template	apache
Apache module FORM handling in C	apache
Apache & JBoss use port 80 at the same time	apache
HELP!Performance issue with Apache, PHP and Symfony~	apache
Configure Apache to use different Unix User Accounts (www-data) per Site.	apache
Apache+PHP write permissions on unix	apache
Apache mod_deflate based on url parameters	apache
Massive URL Change	apache
Apache/Tomcat error - wrong pages being delivered	apache
Using Apache Rewrite to go from HTTP to HTTPS and vice-versa, but I get a 302 response and my app errors out.	apache
mod_jk on windows 64 bit	apache
Why I cannot use my apache server?	apache
redirect http to https for some page in site in APACHE	apache
Can any have the information about the Apache Roller Weblogger software	apache
Double request from mod-rewrite	apache
Redirecting a Directory to a Script on Apache	apache
MPM Prefork Apache Uses Absurd Amount of Memory	apache
mod_rewrite works in .htaccess files but not in apache2.conf	apache
Whats the best way to get multiple instances of an application to run in Apache Tomcat?	apache
Apache is not sending 304 response, if mod_deflate and AddOutputFilterByType is enabled	apache
Apache SetEnvIf trouble	apache
Self-referential URLs	apache
Setting a default Apache RewriteRule entry	apache
Apache mod_rewrite issue with WAMP - shows Error 404 Not found - Joomla 1.5.14 with SEF URL	apache
Mod rewriting? slash to subdomain possible?	apache
Location Bar Doesn't Show Redirected URL	apache
A general linux rights question: Apache and WordPress	apache
Is it possible to convert projects wizard created for MSVS 2005 to MSVS 2008 format autom	visual-studio
Visual Studio: Printing all source files in a solution?	visual-studio
Can Visual Studio 2010 Beta be installed side by side with VS2008?	visual-studio
Visual studio addin - finding current solution folder path	visual-studio
How can I highlight the active line in Visual Studio, without using ReSharper?	visual-studio
.NET VS2005 WinForms: How do i drop a user control onto a form?	visual-studio
colored build output in Visual Studio	visual-studio
How to navigate to Begining/End of a curly brace by selecting one of the braces in Visual Studio 2005.?	visual-studio
Vim style folding for CSS/javascript in Visual Studio	visual-studio
Shortcut for commenting CSS in VS 2008	visual-studio
How do I embed a File Version in an MSI file with Visual Studio?	visual-studio
Tools for inspecting .lib files?	visual-studio
"How to disable the ""auto format"" feature of VisualStudio2008 editor?"	visual-studio
How do I get rid of the unknown property name errors in Visual Studio?	visual-studio
break whenever a file (or class) is entered	visual-studio
Are there any known issues of VS 2003/2005 and 2008 coexisting?	visual-studio
Appropriate VS Project for Multiple .Net Sites	visual-studio
Can't see Methods, etc. in Visual Studio 2008 C# Code	visual-studio
Getting Visual Studio to ignore source control bindings in a solution	visual-studio
Keyword highlighting on selection in Visual Studio 2008	visual-studio
What is the Visual Studio 08 C# Assembly Information GUID setting for?	visual-studio
Visual Studio 2008 Help slow to load... How come?	visual-studio
"VS2008 files and ""start debugging"""	visual-studio
Visual Studio - Publish to multiple locations?	visual-studio
Upgrading to VS 2008 Professional from Web Developer Edition	visual-studio
Is there a Visual Studio plugin that spellchecks strings and comments?	visual-studio
Add Solution Folder for VS 2008?	visual-studio
"[VS] How do I add Debug Breakpoints to lines displayed in a ""Find Results"" window"	visual-studio
Visual Studio won't make debug DLL	visual-studio
"How to ""Add Existing Item"" an entire directory structure in Visual Studio"	visual-studio
Visual Studio hangs on build	visual-studio
how do you add an existing directory tree to a project in visual studio	visual-studio
"Visual Studio 2008 -- Can I change which ""add reference"" tab is selected by default?"	visual-studio
"VS.NET ""watched"" objects and recursive depth"	visual-studio
Can VS_VERSION_INFO be added to non-exe files?	visual-studio
Writing two dimensional array to file and reading two dimensional array from file using Visual C++	visual-studio
Can I change the warning setings for Web Sites in visual studio?	visual-studio
how to work with multiple coincident panel controls in VS 2008 windows forms	visual-studio
What is the shortcut key for Run to cursor	visual-studio
"Any way to do Visual Studio ""project only"" build from command line?"	visual-studio
Visual Studio projects with multiple folders	visual-studio
Visual Studio - tips for managing work on many open files	visual-studio
Programming visual studio macros	visual-studio
Disabling copy of empty text in Visual Studio	visual-studio
Visual Studio: How to trigger an alarm when a breakpoint is hit?	visual-studio
Should I add the Visual Studio .suo and .user files to source control	visual-studio
How to make Error List window automatically active during compilation in visual studio?	visual-studio
Why should I NOT use the /optimize switch to compile my C# code?	visual-studio
How to enter long SQL text sample data with Visual Studio?	visual-studio
"How to ""watch"" character values of a string on Visual Studio?"	visual-studio
How do I find a complete list of extensions installed in VS2008?	visual-studio
How to Prevent Visual Studio launch WcfSvcHost.exe in Debuggin?	visual-studio
How to break on Insert in Visual Studio / SQL Server 2005	visual-studio
How to tell if .net code is being run by Visual Studio designer	visual-studio
Structuring projects & dependencies of large winforms applications in C#	visual-studio
Install VS 2008 Prof.	visual-studio
Rehsarper 4.0 - Renaming a class does not rename the file	visual-studio
Favorite Visual Studio keyboard shortcuts	visual-studio
Why is Visual Studios Installer not picking up dependencies	visual-studio
How can I toggle word wrap in Visual Studio.NET?	visual-studio
Why does Visual Studio 2008 forget where to dock my add-in's window pane?	visual-studio
"In Visual Studio 2008, how can I make control+click do a ""Go To Definition""?"	visual-studio
Good Alternatives to Visual Studio Setup Projects	visual-studio
Convert asp.net project pages from Windows-1251 to Utf-8	visual-studio
How do I stop visual studio from automatically inserting asterisk during a block comment?	visual-studio
CoCreateInstance without an AddRef()?	visual-studio
Advantages of VS 2008 over VS 2005	visual-studio
What is Microsoft's official stance on using WCF with Visual Studio 2005?	visual-studio
Escaping out of the Find and Replace box in Visual Studio 2008	visual-studio
Validate all ASPX, ASCX and HTML files when building	visual-studio
Creating a VS .Net 2003 property macro/variable	visual-studio
How do I open a new visual studio instance using EnvDTE?	visual-studio
Errors in Windows Forms controls in designer view	visual-studio
Visual Studio database project designers	visual-studio
How to Export/Import Toolbars in Visual Studio	visual-studio
Automated release script and Visual Studio Setup projects	visual-studio
Is there a Visual Studio plugin for sorting build output (scrambled from multi-threaded builds)?	visual-studio
How do I get a code window to split vertically in Visual Studio 2008? (not HTML mode)	visual-studio
What do you use (free) to format C# code?	visual-studio
Visual Studio identical token highlighting	visual-studio
How do I rename a Project Folder from within Visual Studio?	visual-studio
Working on a Visual Studio Project with multiple users?	visual-studio
"How do I get the ""Publish Website"" command to emit PDB files for my Visual Studio 2005 Web Site project?"	visual-studio
How can I stop cl.exe from terminating when a user logs out?	visual-studio
Visual Studio: Where is intellisense in the immediate window?	visual-studio
What is the best way to inspect STL containers in Visual Studio debugging?	visual-studio
[Best Practise] Visual Studio Solution Structure for multiple deployable projects	visual-studio
Best Way to ReUse Code When Using Visual Studio?	visual-studio
Integrating a custom gui framework with the VS designer	visual-studio
How do I force Visual Studio to use an Open instance when double clicking a file?	visual-studio
Why does Visual Studio debugging mode does not work properly (performing F5 when F11 was pressed)	visual-studio
VS2008 setup project installing extra dependency files	visual-studio
How can I map out which Visual Studio Solutions use which Projects?	visual-studio
How do you clear your Visual Studio Cache on Windows Vista	visual-studio
VS2008 Macro: Perform action on every code file in the solution	visual-studio
How do I stop Visual Studio from launching a new browser window every single time I hit the Start Debugging button?	visual-studio
Howto Speedup Visual Studio(2005/2008) Toolbox initialization	visual-studio
How do I get output to show up in the Messages pane of the Error List for Visual Studio 2005?	visual-studio
MRU list in Visual studio is missing	visual-studio
Resources for building a Visual Studio plug-in?	visual-studio
Visual Studio: Preserving syntax coloring when pasting code into HTML	visual-studio
Does anybody have experience with Visual Studio 2008 on Windows 7?	visual-studio
"MFC ""Warning: skipping non-radio button in group."""	visual-studio
Number of Classes in a Visual Studio Solution	visual-studio
Where are Visual Studio breakpoints saved?	visual-studio
Suggestions for maintaining Visual Studio vcproj project files in version control	visual-studio
Hidding source control files within Visual Studio's solution tree	visual-studio
Viewing the Visual SourceSafe log inside Visual Studio	visual-studio
Multiple Monitors with Visual Studio 2008	visual-studio
VS2008 Navigate to class definition add-in	visual-studio
What 's your favorate way when debugging your program in Visual Studio?	visual-studio
How do I get rid of the dots!	visual-studio
What is the optimum number of projects in a Visual Studio 2008 solution?	visual-studio
What's a good directory structure for large C#/C++ solutions?	visual-studio
Visual Studio opens Development Servers for all websites in my project	visual-studio
Referencing a COM assembly in Visual Studio vs converting a COM assembly via tlbimp.exe	visual-studio
I can't create New Project on Visual Web Developer 2008 Express	visual-studio
Can Visual Studio put timestamps in the build log?	visual-studio
Unable to debug web service project in Visual Studio 2008	visual-studio
Default News Feed on Visual Studio Start Page (C# Profile)	visual-studio
How to debug external class library projects in visual studio?	visual-studio
Where is the 'Autos' view in msdev 2005 ?	visual-studio
VS get returned value in C# code ?	visual-studio
What do you do about references when unloading a project in Visual Studio?	visual-studio
Managing reference paths between x86 and x64 workstations in a team	visual-studio
Multiple web application deployment targets in Visual Studio 2008?	visual-studio
How do you invoke the Visual Studio Preprocessor from the command line?	visual-studio
Visual Studio refactoring: Remove method	visual-studio
Give me awesome Visual Studio keyboard short cuts!	visual-studio
How to quickly organize functions in source code (c#) to order by alpabetical order?	visual-studio
Solution: Per application, or per application suite.	visual-studio
What is the best way to deploy a VB.NET application?	visual-studio
Solution items cross several web projects in Visual Studio	visual-studio
Can Visual Studio 2008 work with Team System 2005?	visual-studio
How can I customize the syntax highlighting in Visual Studio 2005?	visual-studio
LinqPad Feature - Does VS do this?	visual-studio
Creating mdf file from sql script	visual-studio
What's event that Visual Studio 2008 do after post build event?	visual-studio
Debugging sometimes very slow	visual-studio
Building Projects in Visual Studio	visual-studio
Is a seperate Visual Studio license required for a build machine?	visual-studio
VMware Workstation overrides VS2008 hotkeys	visual-studio
How do I tell VS 2008 to stop putting byte-order marks in front of my files?	visual-studio
designing Panels without a parent Form in VS?	visual-studio
What is tab #13119 on  my VS 2008 toolbox?	visual-studio
How to free up a key combination in visual studio?	visual-studio
Make visual studio deploy a folder's content without having to update it in the project	visual-studio
Debugging with command-line parameters in Visual Studio.	visual-studio
Can you print JavaScript variables from a Visual Studio 2008 Tracepoint?	visual-studio
[Visual Studio 2003] Setting environment variables in pre-build event and using in compilation step	visual-studio
