text	label
scala 2.8 control Exception - what is the point?	scala
How to use scala.None from Java code	scala
What is the rationale behind having companion objects in Scala?	scala
How many Scala web-frameworks are there?	scala
"How to write a lazy, variable argument version of ""orElse"""	scala
Why does the empty string not match as Seq.empty?	scala
Method call inside Actor freezes in Scala	scala
Can I get AST from live scala code ?	scala
Launch Scala REPL programatically?	scala
Need some help with Scala's instance variables	scala
Scala objects not changing their internal state	scala
Can someone explain this article about enforcing race safety in Scala.	scala
Scala 2D Animation library	scala
Changing XML Namespace with Scala	scala
why doesn't scalac optimize tail recursion?	scala
Scala:  binary incompatibility between releases	scala
scala - Getting a read-only sublist view of a List	scala
Why were the case classes without a parameter list deprecated?	scala
Parser combinator not terminating - how to log what is going on?	scala
Security of scala runtime	scala
Web Application Development on Scala	scala
What's the best Scala build system?	scala
How to add a method to a Scala Enumeration object?	scala
In scala, how would to declare static data inside a function?	scala
Wanted: Good examples for Scala database persistence	scala
Netbeans scala plugin - no documentation	scala
How do I create an XML root node in Scala without a literal element name?	scala
Regex.MatchData returning null: why not Option[String]?	scala
Using type aliases to Java enums	scala
Elements of Scala Style?	scala
anybody konws gui dsl on scala?	scala
Is there an easy (idiomatic) way to convert a java.lang.reflect.Method to a Scala Function Value?	scala
Handling Error on Insert PlayFramework 2.0 Scala	scala
parser combinator: how to terminate repetition on keyword	scala
How should I organize implicits in my Scala application?	scala
What good are right-associative methods in Scala?	scala
Inheritance and type parameters of Traversable	scala
Default type-parametrized function literal class parameter	scala
Does Scala run on GWT?	scala
Cannot get FeatureSpec structure to show up in the output when combined with JUnitSuite	scala
<:< operator in scala.	scala
Writing applications with Scala actors in practice II	scala
"Scala: How to define ""generic"" function parameters?"	scala
Scala equivalent of Java java.lang.Class<T> Object	scala
Concurrent map/foreach in scala	scala
scala Map filterKeys: Projection cannot be assigned to a Map reference	scala
Scala case classes in collections	scala
A better way to test the value of an Option?	scala
Scala Remote Actor Security	scala
How to convert a scala.List to a java.util.List?	scala
Substantial Android development in Scala	scala
java.nio.BufferUnderflowException when processing files in Scala	scala
Why it is allowed to point to constructors parameters?	scala
"Scala type inference failure on ""? extends"" in Java code"	scala
Scala non-covariant immutable Set	scala
Using alternative comparison in HashSet	scala
Scala Type Failure in 2.7: is there a workaround?	scala
Scala: type variance and pattern matching between two equal types	scala
How to integrate Scala language with Spring Security	scala
Unit testing Scala	scala
using REST webservices as a datasource for Lift ?	scala
Scala: can't write setter without getter?	scala
Niewbie OutOfMemory problem	scala
How is pattern matching in Scala implemented at bytecode level?	scala
How to expose a constructor variable(sic!) as read-only?	scala
What are the relationships between Any, AnyVal, AnyRef, Object and how do they map when used in Java code?	scala
Can a range be matched in Scala?	scala
Scala: Parallel assignment of Tuples	scala
varargs puzzle?	scala
Does Scala's pattern matching violate the Open/Closed Principle?	scala
scala: 'def foo = {1}' vs 'def foo {1}'	scala
Modern Java alternatives	scala
What is Scala blogs that you regularly follow?	scala
Scala: is it possible to override default case class constructor?	scala
garbage collecting scala actors	scala
Scala: Exposing a JDBC ResultSet through a generator (iterable)	scala
Avoiding Scala memory leaks - Scala constructors	scala
Why is the + operator for List deprecated in Scala?	scala
capture types of varargs parameters	scala
Syntactic sugar for compile-time object creation in Scala	scala
create a database with scala/lift and a simple interface to log in	scala
"Merge sort from ""Programming Scala"" causes stack overflow"	scala
Scala 2.8 Actors	scala
pattern matching on a series of values in scala	scala
What compromises Scala made to run on JVM?	scala
scala / lift example of form processing	scala
Non deprecated way of appending an element to a List in Scala 2.7.5?	scala
Non-mathematical use cases for functional programming ?	scala
Is there an easy way to integrate scaladoc into IntelliJ Idea?	scala
Convert Option[Object] to Option[Int] Implicitly	scala
What is Scala equivalent of Java's static block ?	scala
Scala - modifying nested elements in xml	scala
How can I define an anonymous generic Scala function?	scala
What are the biggest differences between Scala 2.8 and Scala 2.7?	scala
Do you plan to use the Scala programming language and on what project?	scala
"what is wrong: ""value Parsers is not a member of package scala.util.parsing.combinator""?"	scala
Why are my Scala types not matching?	scala
How to control TCP_NODELAY setting for Scala remote actor ?	scala
Scala isn't allowing me to execute a batch file whose path contains spaces.Same Java code does.What gives?	scala
"How to write ""asInstanceOfOption"" in Scala"	scala
Scala: how can I sort an array of tuples by their second element?	scala
Is there any game engine in Scala?	scala
Why is PartialFunction <: Function in Scala?	scala
Using Scala as a scripting language from Eclipse	scala
Does Scala have an equivelant to C# yield?	scala
How are Scala traits compiled into Java bytecode?	scala
Composing actors	scala
"Is there a ""SELF"" type in scala thet represents the current type?"	scala
Match multiple cases classes in scala	scala
"Question on Scala Closure (From ""Programming in Scala"")"	scala
Functional equivalent of if (p(f(a), f(b)) a else b	scala
graph database to store several time based data values, result of simulation	scala
Scala actors: receive vs react	scala
How to use objetcs as modules/functors in Scala?	scala
In Scala, why can't I partially apply a function without explicitly specifying its argument types?	scala
What are the best features of Scala?	scala
ensime scala errors (class scala.Array not found, object scala not found)	scala
deserializing a json object through Lift-JSON	scala
How to create a decent toString() method in scala using reflection?	scala
Lazy Quicksort in Scala	scala
How does one write the Pythagoras Theorem in Scala?	scala
Is there an equivalent in Scala to Python's more general map function?	scala
Maximum size of Actor Queues?	scala
O(1) conversion from mutable.Map to immutable.Map?	scala
How would I do multiple concurrency in Scala, without the need for messages?	scala
Scala Enumeration values not ordered?	scala
Passing enum parameter to a case class does not work	scala
How to use scalax.io.CommandLineParser?	scala
Scala compiler error due to constructor parameter (property) having same name in both base and derived class and used in derived method	scala
Deploying simple scala app(non-webapp) managed with maven	scala
List[Map[String,A]] to database table in scalaquery	scala
What should be done to have 'Value' in the enumeration ?	scala
Unit testing scala actors	scala
Sorting objects based on Double values?	scala
Scala best way of turning a Collection into a Map-by-key?	scala
Scala and Swing GUI applications	scala
Implicit conversion from String to Int in scala 2.8	scala
Pattern matching with multiline XML case	scala
Scala and the Java Memory Model	scala
How can I convert scala.xml.Elem to something compatible with the javax.xml APIs?	scala
Scala XML Pattern matching and Attributes	scala
What are the exact versions of stuff you have to install in order to be able to step-debug a Scala program?	scala
Is there an easy way to get the Scala REPL to reload a class or package?	scala
Code Coverage Tools for Scala	scala
Is is possible to capture the type parameter of a trait using Manifests in Scala 2.7.7?	scala
A light weight Scala fork join syntax	scala
In Scala, how does one write a class with a constructor, not all of whose arguments are class members ?	scala
Should I study Scala?	scala
Scala: Is there a way to use PriorityQueue like I would in Java?	scala
How do I enable continuations on Scala 2.8?	scala
Why does Oracle require TO_NCHAR when binding SQL_C_WCHAR text via ODBC	oracle
Oracle PL/SQL: Any benefits in changing PLSQL_CODE_TYPE from interpreted to native ?	oracle
Fully unrap a view	oracle
paging with oracle	oracle
Programmatically marking an Oracle BPEL task complete	oracle
Oracle - How to have an out ref cursor parameter in a stored procedure?	oracle
Does using a VIEW for SELECT operations can imporove performance?	oracle
Oracle connections problem	oracle
Last day of the month with a twist in SQLPLUS	oracle
SQL for listing Oracle Stored Procedures	oracle
Control which columns become primary keys with Microsoft Access ODBC link to Oracle	oracle
Oracle TEMPORARY TABLESPACE	oracle
Generic-like behavior in PL/SQL procedure parameters	oracle
What is the SQL Server equivalent to Oracle's Virtual Private Database?	oracle
What is a Simply way to combine groupped values in one field?	oracle
Should I use TNSNAMES.ORA or tnsnames.ora?	oracle
A useful example of when to use vsize function instead of length function in Oracle?	oracle
Oracle how to export query to a text/csv file	oracle
OracleDependency not firing event	oracle
Network Outage Causes Stored Procedure Querying Across DB Link to Hang Forever	oracle
MaxValue Partition Name	oracle
Storing Array of Floats as a BLOB in Oracle	oracle
How do I close an OracleConnection in .NET	oracle
Inserting multiple rows into Oracle	oracle
SSRS Report from Oracle DB - Use stored procedure	oracle
Oracle - dynamic column name in select statement	oracle
Why does Char(1) change to Char(3) when copying over an Oracle DBLINK?	oracle
How to cancel a long-running Database operation?	oracle
What is the syntax for creating a timestamp(6) type field in Oracle	oracle
Oracle Documentation Generation Tool.	oracle
MODIFY COLUMN in oracle - How to check if a column is nullable before setting to nullable?	oracle
How to get UTC value for SYSDATE on Oracle	oracle
Is there an easy way to convert HTTP_ACCEPT_LANGUAGE to Oracle NLS_LANG settings?	oracle
"Can I send ""batched"" INSERTs to Oracle?"	oracle
Accessing URL parameters in Oracle Forms / OC4J	oracle
How to know which stored procedures are running in an Oracle database?	oracle
How to recreate an oracle 9i database from backup files (ora files)	oracle
Is there a way to specify a super-type sub-type relationship in Oracle Designer?	oracle
Oracle SQL*Loader getting CDATA values...	oracle
Is there a tool to DB Diff on 'data' for an ORACLE database?	oracle
What type of index in best for DATE type on Oracle?	oracle
Connecting to Oracle with 32 bit apps running on Vista 64 bit	oracle
Oracle - Best SELECT statement for getting the difference in minutes between two DateTime columns?	oracle
Does ODP.net close a ref cursor when the connection closes?	oracle
Oracle: What does `(+)` do in a WHERE clause?	oracle
odp.net tracing	oracle
Getting Oracle client to work on Windows 7 RC	oracle
How to find out when an Oracle table was updated the last time	oracle
How do you add textboxes to Oracle APEX reports?	oracle
How to get column info from oracle table you don't own (without using describe)?	oracle
How do I test if a column equals empty_clob() in Oracle?	oracle
Whats wrong with this Cursor	oracle
Print text in Oracle SQL Developer SQL Worksheet window	oracle
Oracle ROWNUM	oracle
Oracle works better with Windows or Linux? give your answer based on your experience.	oracle
How to avoid storing passwords in the clear for tomcat's server.xml Resource definition of a DataSource?	oracle
problem with oracle sqlplus with whitespace in the path of the @ command	oracle
How do I find the definition of a system-named constraint in Oracle?	oracle
Oracle: Combine multiple results in a subquery into a single comma-separated value	oracle
Oracle Date Rounding	oracle
How many temporary extents is my oracle 10g session using?	oracle
How do I execute private procedures in an Oracle package?	oracle
Display contents of Oracle AQ SYS.AQ$_JMS_TEXT_MESSAGE	oracle
Optimizing SELECT Query on Oracle 10 Dense Unique Index	oracle
Oracle 11g SQL select max integer value of varchar column	oracle
How could predicate pushing on an inline view slow down a query?	oracle
Identifiers in a Diamond Relationship between Tables	oracle
Manually inserting data in a table(s) with primary key populated with sequence	oracle
ORA-03113: end-of-file on communication channel after long inactivity in ASP.Net app	oracle
Rolling forward the archivelog and online redo logs to the restored database	oracle
Oracle Database to Class Diagram	oracle
Is it safe/possible to delete code from the table dba_source in Oracle 10g?	oracle
Porting JDBCRealm from tomcat to OC4J	oracle
What is the fastest way to insert data into an Oracle table?	oracle
[Oracle] - Alternatives to Toad	oracle
Oracle Forms/Applications in Internet Explorer 8 using JInitator	oracle
How to permit update of a view's results in Oracle?	oracle
Is there an Oracle SQL tool that builds insert statements from a result set?	oracle
What is native web services?	oracle
Oracle Application Server; What role in an organization typically supports the middle tier?	oracle
Connection to Oracle without a username or password	oracle
Identifiers in a one to many relationship	oracle
Always get exception when trying to Fill data to DataTable	oracle
What could cause an ORA-00936 - Missing Expression with the following sql?	oracle
"Any difference between ""current row"" and ""0 preceding/following"" in windowing clause of Oracle analytic functions?"	oracle
Oracle Pl/SQL: Loop through XMLTYPE  nodes	oracle
ORA-12638: Credential retrieval failed	oracle
Are Oracle stored procedures faster than in line SQL for a Microsoft.NET application ?	oracle
Reading CLOB column is slow...	oracle
Oracle Export: ORA-31600: invalid input value EMIT_SCHEMA for parameter NAME in function SET_TRANSFORM_PARAM	oracle
Oracle DATE Index	oracle
How to improve performance in Oracle using SELECT DISTINCT	oracle
How to select a related group of items in Oracle SQL	oracle
Oracle 9i: Supposedly missing right parenthesis	oracle
Microsoft provider for Oracle and positional parameters	oracle
Oracle utl_match special characters	oracle
Oracle empty strings	oracle
Howto import an oracle dump in an different tablespace	oracle
Is it possible to use a database link between an oracle database and a postgresql database on different physical servers	oracle
SQL SELECT: combining and grouping data between three tables using subqueries	oracle
How to develop an after serverror trigger in Oracle?	oracle
Please recommand some book on Oracle and Apex	oracle
Detecting the number of ORACLE rows updated by a OCI OCIStmtExecute call	oracle
Oracle 8i Query Help	oracle
How to extract leaf nodes from Oracle XMLTYPE	oracle
Setting global_names parameter.	oracle
Oracle detection date of daylight savings change	oracle
When programatically creating a DSN for an Oracle database how can I reliably tell the driver name?	oracle
"How do I Suppress ""PL/SQL procedure successfully completed"" message in sqlplus?"	oracle
Double Quotes in Oracle Column Aliases	oracle
How to refer dynamically to another database user?	oracle
What is the default Precision and Scale for a Number in Oracle?	oracle
What to look for when downgrading from Oracle 10g to 9i?	oracle
Performance of Dynamic SQL with Bind vs Normal SQL within Package	oracle
Refering to environment variable in oracle sql files on Linux and Windows	oracle
Problem with Oracle Application Server SSL Certificates	oracle
secure Oracle connection from java applet	oracle
Continuing Inserts in Oracle when exception is raised	oracle
Why is oracle spewing bad table metadata?	oracle
Oracle Express Edition - Can not connect remotely (plus others)	oracle
Oracle Hierarchical query: how to include top-level parent	oracle
Can I run an arbitrary Oracle SQL script through ODP.NET?	oracle
How to pass an array parameter in TOAD	oracle
Oracle lag between commit and select	oracle
Oracle materialized view tuning	oracle
Oracle in-line method to produce CSV for relation	oracle
Oracle 10gr2: ensure timestamps are between 9am and 5pm	oracle
"Oracle: how to run a stored procedure ""later"""	oracle
Default row ordering for select query in oracle	oracle
Scripting out Oracle objects	oracle
How do you rate Oracle Portals as a platform?	oracle
What's an OCCI context and environment?	oracle
Oracle error	oracle
Oracle stored procedure OUT parameters	oracle
"Oracle connection problem on Mac OSX: ""Status : Failure -Test failed: Io exception: The Network Adapter could not establish the connection"""	oracle
how to use a variable in oracle script for the table name	oracle
Oracle database connections - what are all the fields I need to fill in?	oracle
Top 5 time consuming SQls in Oracle	oracle
What is your experience with Oracle's result caching feature?	oracle
Import Date Format mmddyyyy	oracle
Oracle - ODBC connection using MS Access error (ORA-12154)	oracle
Oracle Generic DB Link not working	oracle
Explain Plan for Query in a Stored Procedure	oracle
DB Index speed vs caching	oracle
Issue in Oracle Sql Query	oracle
Oracle: Create table as select from another database?	oracle
2 Oracle Question	oracle
ORACLE - Exporting Procedures / Packages to a file	oracle
Oracle Associative Array TYPE is not able to use in USING statement (If  TYPE is declared within Package)	oracle
PL/SQL: Problem in WHERE clause ( don't know how I can address results from DECODE() function in WHERE clause).	oracle
JPA EntityManager, how does it work??	hibernate
How Do I Retrieve The Class Name From Hibernate?	hibernate
how to do hibernate mapping for table or view without a primary key	hibernate
List sorting and ordering problem...	hibernate
In hibernate how do I always use db server's timestamp?	hibernate
Hibernate/NHibernate mapping file editor	hibernate
Hibernate Annotation Join table question	hibernate
not able to delete	hibernate
Hibernate L2 Caching and Many-To-Many relationships	hibernate
How to integrate Hibernate with JBoss 4.2.x server?	hibernate
Why this simple hibernate sample doesn't work?	hibernate
How to execute sql-script file using hibernate?	hibernate
recover Hibernate session state after a failed insert	hibernate
hibernate     @GeneratedValue  correct?	hibernate
Interceptor's getEntityName is not used. Bug in Hibernate?	hibernate
In Hibernate, is there any difference between session.get() and session.load() besides how bad IDs are handled?	hibernate
in NHibernate, map 4 similar columns to list<string>	hibernate
How do I make/develop Hibernate caching?	hibernate
JPA and Hibernate Fetch ignoring Associations?	hibernate
Why the name 'Hibernate' chosen for Hibernate?	hibernate
Hibernate HQL Query : How to set a Collection as a named parameter of a Query?	hibernate
NHibernate using single configuration file to connect to multiple dbs	hibernate
Searching object property in a predefined list using HQL	hibernate
hibernate foreign key	hibernate
JPA Map<String,String> mapping	hibernate
Hibernate: When to use getSession() and when to use getCurrentSession()?	hibernate
Hibernate: Persisting Objects	hibernate
Can I have a collection of IUserType instances?	hibernate
Spring + Hibernate : a different object with the same identifier value was already associated with the session	hibernate
handling hibernate UnsupportedOperationException: Can't write to a readonly object	hibernate
Hibernate error: cannot resolve table	hibernate
transaction timeout not working on hibernate with oracle	hibernate
How to construct a hibernate query that uses a single element of all elements in a collection?	hibernate
Issue Using Hibernate Criteria object with composite key	hibernate
HQL Order by qurey giving problem	hibernate
Are Hibernate and RDLC alternatives to each other?	hibernate
Hibernate one-to-one entity association with shared PK between 3 classes	hibernate
Making hibernate not include fields from joined tables in select clause	hibernate
Problems using eclipse Hibernate plugin - could not locate sessionfactory in JNDI	hibernate
Hibernate, C3P0, Mysql -- Broken Pipe	hibernate
Hibernate multi level of transaction	hibernate
Hibernate: How to set NULL query-parameter value with HQL?	hibernate
SwarmCache Hiberanate configuration	hibernate
Passing parameter to hbm2ddl	hibernate
Hibernate. big Results and Pagination	hibernate
Hibernate on hypersonic in prodaction?	hibernate
can Use Hibernate and Tomcat Connection pool at same time?	hibernate
cast(val as char) in hibernate config named query	hibernate
how to get value form 2nd table with out join in hibernate	hibernate
"Hibernate Criteria API equivalent for ""elements()"""	hibernate
Hibernate: lazy-loading doesn't work on one-to-many mapping on set	hibernate
Using Hibernate Validator with JPA and Spring	hibernate
Generating a SWING/Gui from Hibernate	hibernate
HQL query equivalence: Why are them different	hibernate
Adding a enum as a class property in HBM.	hibernate
Hibernate SQL Audit Logging	hibernate
How to point to other table's ID with hibernate?	hibernate
Hibernate: unmapped class association exception	hibernate
how to configure hibernate 3.3 in eclipse galileo?	hibernate
Hibernate: How to make Hibernate delete records from child table when deleting parent if child is linked to parent with many-to-one?	hibernate
Hibernate cannot recover after socket has timed out	hibernate
hibernate cascade deletion  example	hibernate
Hibernate Criteria query - Class cast exception	hibernate
Cascading updates with business key equality: Hibernate best practices?	hibernate
What is the missing parameter in connection pooling?	hibernate
Hibernate query (not SQL) logging	hibernate
want each call to save to commit	hibernate
HQL with a collection in the WHERE clause	hibernate
Hibernate cannot remove child from database	hibernate
Hibernate, instrumentation and delete cascade order	hibernate
Hibernate list operation question	hibernate
How to get Hibernate configuration properties?	hibernate
Hibernate - One design problem	hibernate
HQL Problem	hibernate
Hibernate CollectionOfElements EAGER fetch duplicates elements	hibernate
Double-logging in Hibernate	hibernate
Hibernate and Sql Server best Practicies	hibernate
Hibernate collection handling  basics	hibernate
How to use hibernate interceptors to populate extra fields in a join table?	hibernate
How do I externalize named queries in a Hibernate annotations app?	hibernate
Retrieve emebedded or component using Hibernate Criteria api	hibernate
@Range based hibernate validation checks	hibernate
Generate value for a property in hibernate	hibernate
Hibernate displaytag big lists	hibernate
Setting FetchMode in native Hibernate	hibernate
Hibernate: How to map a *.hbm.xml file in a different folder?	hibernate
Mapping a list in hibernate by ordering instead of an index-field	hibernate
how to implement lazy loading in hibernate	hibernate
Hibernate Criteria contains-in on an association to a table	hibernate
Problem with mapping tag in hibernate configuration file	hibernate
How to validate database schema programmatically in hibernate with annotations?	hibernate
Cannot run JBoss Cache as a second level cache for Hibernate in JBoss 5	hibernate
Hibernate bi-directional many-to-many cascade confusion	hibernate
how to connect to mutiple databases in hibernate	hibernate
Can we use union in hibernate	hibernate
hibernate cascade question	hibernate
map (key ,value)	hibernate
"Mapping Hibernate ""Custom"" Subclasses"	hibernate
@ForeignKey in Hibernate 3.5-beta1	hibernate
Hibernate Exception	hibernate
Hibernate Transaction question	hibernate
Lazily loading a clob in hibernate	hibernate
Hibernate : Java Application must be restarted for data to be realoaded.	hibernate
Persisting large files with Hibernate Annotations	hibernate
Hibernate - ManyToOne - Save - org.hibernate.TransientObjectException:	hibernate
Hibernate mapping a second @Embeddable field in a subclass	hibernate
Rolling back foreign key relationships with Hibernate	hibernate
What are the differences between the different saving methods in Hibernate?	hibernate
Inserting a generated value into a Hibernate record	hibernate
Hibernate Map Mapping Problem	hibernate
Hibernate saveOrUpdate fails when I execute it on empty table.	hibernate
Why does hibernate-entitymanager-3.3.2.GA depend on hibernate-3.2.6.ga?	hibernate
Hibernate/JPA/HSQLDB Enum issues...	hibernate
How do you turn on a hibernate filter for a particular entity by default?	hibernate
Hiberate: Collections of Collections	hibernate
hibernate many-to-one hql query, when inner join fetch property not associated	hibernate
Hibernate: Is there a way to programatically create new tables that resemble an existing one?	hibernate
Hibernate Mapping Conditional Many-To-One	hibernate
How to limit user access at database level in Hibernate	hibernate
Case-insensitive search using Hibernate	hibernate
Use two databases concurrently in Hibernate	hibernate
Mapping multi-Level inheritance in Hibernate with Annotations	hibernate
Is there any way to declare final fields for Hibernate-managed objects?	hibernate
Hibernate Annotation Placement Question	hibernate
Table per Concrete Class Hierarchy in Hibernate	hibernate
many-to-many mapping not working, one side is set to inverse.	hibernate
hibernate hbm2hbmxml	hibernate
Enum tables in Hibernate/NHibernate	hibernate
hibernate interceptors : afterTransactionCompletion	hibernate
Preventing NaN from being persisted by Hibernate	hibernate
HIbernate - HBM.xml Automatic generation from DB Schema	hibernate
Hibernate and Unexpected end of Subtree exception	hibernate
Multiple Session Factories under Spring/Hibernate	hibernate
Add (external) relationship (tagging) to existing Hibernate entities	hibernate
hibernate criteria - querying tables in n:m relationship	hibernate
hibernate optimistic locking with lazy OneToOne associations	hibernate
Using Spring + Hibernate Transactional cache in Tomcat?	hibernate
Hibernate custom type definitions	hibernate
Nhibernate HQL SQL Server 2005 / 2008 CONTAINSTABLE	hibernate
first level hibernate cache , modify record directly at DB	hibernate
concurrency in hibernate	hibernate
Hibernate: Many-to-one using Formula	hibernate
Hibernate getting on my nerve. Delete question on One To One relationship.	hibernate
How to know a entity is going to insert or update	hibernate
Getting Hibernate to do simple updates, instead of enormous select then updates...	hibernate
Hibernate: comparing current & previous record	hibernate
Hibernate, MySQL Views and hibernate.hbm2ddl.auto = validate	hibernate
Hibernate MappingException Unknown entity: $Proxy2	hibernate
Hibernate-like framework for C++	hibernate
Persist collection fields with hibernate	hibernate
Mouseover in NSTableView	cocoa
cocoa/objective-c: get macbook icon	cocoa
How to automatically expand all children of an nsoutlineview in cocoa?	cocoa
How do I bind the enabled binding of a button to whether or not an NSArrayController has a selection?	cocoa
Setting up KVO for calculated values, based on calculated values.	cocoa
Core animation code structure/conventions	cocoa
Should frameworks be put in /Library/Frameworks or in the application bundle when putting multiple applications in one bundle	cocoa
Key-Value-Observing a to-many relationship in Cocoa	cocoa
Getting the list of running applications ordered by last use	cocoa
Best way to handle multiple NSTableView(s)	cocoa
Customising an NSTextFieldCell depending on the isEnabled biding of the table column	cocoa
NSOutlineView - Auto-expand all nodes	cocoa
customize Finder 'get info' window?	cocoa
Creating a bundle - What's going wrong?	cocoa
Object communication - Passing self to another object / Objective-C, Cocoa	cocoa
VPN in cocoa app	cocoa
"What does the ""Generate Validation Methods"" checkbox in the Managed Object Class Generation dialog do?"	cocoa
Drawing a view hierachy into a specific content in Cocoa	cocoa
Filtering data in an NSPopUpButtonCell in an NSTableView	cocoa
contextual munu and action:@selector	cocoa
NSTreeController - malloc double free error	cocoa
SetHidden not working	cocoa
using frameworks in a command line tool	cocoa
Core Animation View Intermittently Not Appearing	cocoa
Creating Cocoa PopUpMenus programatically and Getting code form a GUI item built with the interface builder	cocoa
How do I create a temporary file with Cocoa?	cocoa
How does [UIView beginAnimations] work?	cocoa
How are the classes in the Sketch example AppKit application separated into Models/Views/Controllers?	cocoa
How can I make my NSScroller subclass have a different width?	cocoa
How would you make a checkbox delete a row in a table if checked (Cocoa) ?	cocoa
Debugging Cocoa app	cocoa
What do these errors in the XCode Debugger Mean?	cocoa
How to gain access to all  open windows on Desktop using Cocoa?	cocoa
Encoding special characters	cocoa
Apple documentation a bit lite?  tips?	cocoa
Fun Function Every Minute In Cocoa	cocoa
What does the NS prefix means?	cocoa
Un-Recognized Selector Sent to Instance Error.	cocoa
Adding non-model nodes to an NSTreeController	cocoa
Can you write Cocoa apps with HTML/CSS and Javascript?	cocoa
NSTableView -setDataSource not working when triggered by FSEvents	cocoa
How to debug the main SafariPlugIn project ?	cocoa
I want to allocate memory for 700 MB to 800 MB Image size	cocoa
Handle OSX Dock Drag N Drop	cocoa
Managing multiple asynchronous NSURLConnection connections	cocoa
Cocoa: Measure time between keypresses?	cocoa
Making the Code check to see if the Text in a Text box matches any of the Strings in an NSArray.	cocoa
Syncing a Core Data Model With A Web Service	cocoa
How do I convert an NSString into something I can use with FSCreateDirectoryUnicode?	cocoa
UIViewController vs. UIView - which one should create subviews?	cocoa
Read input from a cocoa/foundation tool console?	cocoa
Cocoa Framework Issue	cocoa
NSOutlineView, NSTreeController and willDisplayCell	cocoa
Best way to make NSRunLoop wait for a flag to be set?	cocoa
Get NSIndexSet from NSArray	cocoa
Why are there more files/hardlinks with the same iNode than the reference count shows?	cocoa
Apple PhotoSearch Example Code - Need Help.	cocoa
Binding a custom NSView: Does it demand creating an IBPlugin ?	cocoa
unrecognized selector sent to instance with a drawer	cocoa
Observing self in Cocoa	cocoa
Cocoa: Quartz, Core Graphics, Context vs View. Oh My!	cocoa
How to add a checkbox in a alert panel?	cocoa
How to show the Logged Messages window in Xcode	cocoa
why does the cocoa 64 bit garbage collector not release memory?	cocoa
Traversing multiple Core Data objects using NSPredicate	cocoa
Cocoa NSView changing autosizing properties	cocoa
nswindowcontroller	cocoa
Cocoa: Laying out dates on a month-view calendar	cocoa
Problems with IBOutlet getting nil.	cocoa
Does NSString stringWithCString: length: retain the byte array I pass in?	cocoa
How to programatically add an object to a bound NSMutableArray?	cocoa
How do I collect key input in a video-game style Cocoa app?	cocoa
IP Address? - Cocoa	cocoa
how to call the c static library in a cocoa app ?	cocoa
How do I keep an NSPathControl updated with the selected cell in an NSBrowser	cocoa
UINavigationController and autorotation.	cocoa
How to make an NSString path (file name) safe	cocoa
how to get the image of MAC System icon in Finder?	cocoa
"Making an NSTextField act like a ""microwave timer"", store as NSNumber"	cocoa
Using NSFontPanel in Cocoa	cocoa
How do you make a Menu Bar Item display how many rows there are in a table?	cocoa
Can I use NSURLCredentialStorage for HTTP Basic Authentication?	cocoa
How to change tint color of Cocoa's NSLevelIndicator?	cocoa
How to controll the webview in the scrollview with the scrollview's controller?	cocoa
Why does Spotlight sometimes not run my query?	cocoa
Cocoa/Objective-C: how much optimization should I do myself?	cocoa
Delegate methods of NSTextField using NSNotification	cocoa
Send An Action Cocoa - IBAction	cocoa
Cocoa Keyboard Shortcuts in Dialog without an Edit Menu	cocoa
How do I find the pixel position of a character in an NSTextView?	cocoa
Remove correctly selected NSManagedObjects	cocoa
Executing simple commands with Cocoa and Sdef.	cocoa
Count of chars in NSString or NSMutableString?	cocoa
A good place to find Interface Builder plugins…	cocoa
"Lower case ""k"" in Cocoa"	cocoa
Where do you put cleanup code for NSDocument sub-classes?	cocoa
NSView with variable number of items inside	cocoa
Best practices for using version-controlling on Cocoa projects	cocoa
Objective-C networking - best practices?	cocoa
Any reason to use NSViewAnimation over CoreAnimation techniques?	cocoa
How do you change the look of a check box?	cocoa
Hide a window in cocoa from awakeFromNib	cocoa
How do I find the correct case of a filename?	cocoa
Why would NSWindow with NSTableView not resize?	cocoa
iPhone Dev: passing object from controller to a view	cocoa
What folder should my application write its launchd file?	cocoa
Using single quote when building a string in Cocoa	cocoa
Providing data as needed for QTMovie	cocoa
How do you make a button remove a row with Core Data in an Outline View?	cocoa
Abstract class memory management in Cocoa	cocoa
NSScanner - Scan Next Line into String	cocoa
Printing an NSImage	cocoa
how to add a menu into the Safari MenuBar or add a button into it's MainWindow?	cocoa
How to add these object with name to the array by this order?	cocoa
Weird build error, problem with class name?	cocoa
Core Animation... cyclic animations?	cocoa
Mouse event is not detected on my NStableview + cocoa	cocoa
Is it possible to access the previous/current value of a proxy object using KVO?	cocoa
Debugging a Cocoa droplet application in Xcode	cocoa
Garbage Collection Crash using NSImage	cocoa
Creating a quick look style zooming effect	cocoa
UNIX Domain Sockets and Cocoa	cocoa
How to display unarchived custom NSView objects	cocoa
Is there a way to programmatically determine the proper sizes for Apple's built-in controls?	cocoa
Unfiltering NSPasteboard	cocoa
Flipping Quicktime preview & capture	cocoa
User-friendly approach for network streaming, playing and seeking of audio in Mac OS X	cocoa
Simplifying a complicated Cocoa-Touch View Controller	cocoa
Device Information from NSEvent/CGEvent	cocoa
CATransform3D vs. CGAffineTransform?	cocoa
₡urr€nc¥ i$ Ki₤₤ing Me!	cocoa
Scroll bars in NSTokenField	cocoa
Call another program's functions?	cocoa
What are the factors to decide between using Core Data versus rolling out a custom model?	cocoa
How would one implement a sidebar similar to Mail/iTunes/Finder/etc in Cocoa/IB?	cocoa
NSColor with calibrated values works differently than regular color??	cocoa
Remove white backgrounds from images	cocoa
Can we use cocoa httpserver in ipad?	cocoa
Accesing A NSArray.	cocoa
How to declare a function in Cocoa after the function using it?	cocoa
How do I get controls on an NSPanel to look correct?	cocoa
NSButton default button with blueish look	cocoa
NSDateFormatter won't parse dates using locale settings?	cocoa
Ensure a subprocess is dead in Cocoa	cocoa
Using NSProxy and forwardInvocation:	cocoa
How does one reproduce the inset text style when drawing text with Mac OS X Cocoa?	cocoa
Cocoa core data self referential interface builder question	cocoa
Duplicating views	cocoa
Am I using NSTimer correctly in iPhone View-based app?	cocoa
focus a NSTextField	cocoa
Mac OSX System menu name w/Java?	osx
Upgrading project to XCode 3.2 under Snow Leopard won't debug	osx
Good framework for the game of Go (weiqi, baduk)?	osx
USB (PNY 4GB) suddenly appears empty - mounts, but name is strange, files not there	osx
OS X Mac and writing a twain scanning application.	osx
mac and iphone development books 2009	osx
Alternative paradigm for Mac OS X development	osx
Can't Run Netbeans after changing Java to 1.6 on mac	osx
Moving a MAC font to a PC - How?	osx
Is there a public source code repository for the Official Mac Github.com client?	osx
Eclipse IDE speed sluggish on Snow Leopard Macbook	osx
What does it mean when AuthorizationExecuteWithPrivileges() returns -1?	osx
Emacs + Mac OSX and changing default font	osx
Remote debugging under Mac OS X	osx
Best way to export a QTMovie with a fade-in and fade-out in the audio	osx
Visual Studio on remote desktop from a Mac - any issues?	osx
Eclipse development on the Mac	osx
what application can I use to create web .ico files on a mac	osx
How to trace a program from its very beginning without running it as root	osx
How to start Mac OS X password screen	osx
can we build a Mac installer with a delayed restart?	osx
Testing HTTPS files with MAMP	osx
Locking a screen in 10.6	osx
How can I make a program start up automatically in OSX?	osx
changing Mac keychain Password programatically?	osx
How Can I Remove .DS_Store Files From A Git Repository?	osx
Cocoa document-based application with multiple document types	osx
Citrix Server sort of app - on a Mac?	osx
How do you configure the Apache server which ships Mac OS X?	osx
Looking for a skeleton application for a native macosx application (w/ installer script, notify icon, user preferences)	osx
How can I know if the user is in Exposé mode?	osx
Porting a Python app that uses Psyco to Mac	osx
OSX: Get application windows + bounds	osx
Remove Apache	osx
Which eclipse version to use on a Mac? (Carbon or Cocoa)	osx
How to add popup menu on NSToolbar item ?	osx
Single user mode in mac	osx
install java se 6 on a mac without software updater	osx
OS X Data Storage in PLIST Example or Tutorial?	osx
Any risks using Macports?	osx
USB Driver Development on a Mac using Python	osx
How can I format date -u so that the results include timezone offset in a Mac OSX terminal session?	osx
"How to connect to server via ssh but use native ""Connect to Server"" in OS X?"	osx
Is it possible to forward ssh requests that come in over a certain port to another machine?	osx
What are the File Permission Signs @ and + for?	osx
Is it possible to run OSX in a virtual machine?	osx
Erase Safari cookies from Terminal	osx
Getting started with Apache, MySQL, and (PHP, Perl, Python) on a Mac	osx
Codecharge Studio alternatives for mac	osx
Mac Audio framework	osx
What font do xterms (X11) use on max osx and how can I use it in terminal or aquamacs emacs or other applications?	osx
Getting the speaker audio signal and then streaming it out	osx
Converting vector image to Quartz 2D code	osx
installing c++ boost on mac osx leopard -- port fails	osx
What is the Bash command to create a hardlink to a directory in OS X?	osx
GCC without Xcode on OS X	osx
What's the minimum version of OS X that supports File System Events?	osx
Cocoa NSArray/NSSet: -makeObjectsPerformSelector: vs. fast enumeration	osx
Using CoreData with an object?	osx
UNIX/OSX version of semtimedop	osx
Disk Activity in Applescript	osx
writing video from webcam using opencv	osx
How can I programatically change the background in Mac OS X?	osx
What's an easy way to have terminal use a different color based on ssh host name?	osx
Uninstalling partially installed XCode + iPhone SDK	osx
Parser for 32-bit and 64-bit Mach-O binary/executable formats in C++	osx
iTunes Plugin Programming: Intercept Events	osx
Developing Google Gadget on a Mac	osx
What are my options for running Java 6 on OS X?	osx
Compiling PHP-GD on Mac OSX 10.5	osx
What are the alternatives to using phpMyAdmin?	osx
OSX Security Framework NameAndPassword sample application	osx
register a protocol on mac osx?	osx
Mac OS X / RSS Growl Notifications	osx
How do I access (listen for) the multimedia keys (play/pause) in Mac OS X?	osx
osx change file encoding (iconv) recursive	osx
How Should an OS X Drawing Programs Store Custom Data in its PDF PasteBoard Flavor?	osx
monitoring idle time during mac development os x	osx
Binding IKImageBrowserView's zoom to the size of its parent NSScrollView	osx
How have you (or HAVE you) learned keyboard shortcut navigation?	osx
How do I enable applets on Mac Firefox 3.0.1?	osx
How can I access informations about connected storage devices on Mac OS X?	osx
What is the easiest way to have a local LAMP installation for web development on mac OS X ?	osx
Static libraries in version-cross-compiled program	osx
What virtual machine can I use for virtualice Mac OS in Window?	osx
check CPU type at RUN time for C program on MAC	osx
OSX - always hide certain files	osx
Porting C++ code from Windows to the Mac	osx
Using Time Machine for test environment rollback for Mac platform	osx
Odd Behavior With Copy/Paste Into FSI On Mac	osx
Direct access to keyboard events in OSX	osx
Selecting OSX SDK version in Eclipse and Makefiles	osx
On MAC O.S., how to get the name of files that has been dropped onto apple script to boot JAR with the name of file as a argument to JAR	osx
NSImage color shift on Snow Leopard	osx
Preferred path to applications on OSX?	osx
Apple Event Handler Failure (Python/AppScript)	osx
"Create a ""Universal Binary"" from two apps?"	osx
How to offer uninstall of a web browser plugin on the Mac?	osx
SVN errorcode=2 Could not open the requested SVN filesystem	osx
Using an IOService port reference to turn off a device...	osx
what is the equivalent of COM in Mac OS?	osx
CSS: How to increase the size of a OSX submit button	osx
Monitor filesystem activity of a child process on OS X with normal user privileges	osx
Cocoa Won't Capture Shift Modifier?	osx
Getting list of Mac text-to-speech voices programmatically?	osx
How to detect current locale in Mac OS X from the shell	osx
"How to use the alt/option key as the ""meta"" key in NetBeans on OS X"	osx
Unable to find Applications folder in Mac's terminal	osx
Localizing a modern xib-based Mac application	osx
How to detect that an app (such as Quicktime) prevents screensaver to run on Mac	osx
Coming from the Windows World..how are applications installed in OSX?	osx
Why this keyboard intercepting kernel extension doesn't work?	osx
[macosx]does dlopen call open and read functions?	osx
Mac + External drive not recognized as removable storage	osx
SVN Client integrated with OS X's Finder	osx
Changing the font in Aquamacs?	osx
Running a Socket Server in Cocoa	osx
OS X text drawing	osx
Hosted Mac OS X/iPhone development	osx
What's a good beginner setup for C++/Python on OSX?	osx
where to find A mac virtual machine which i can run on windows to test my websites?	osx
List potential applications that could open a file	osx
Simulate USB insertion on OSX via software	osx
Open Directory directory domain name on Mac OS X	osx
Web Service solutions from Mac	osx
Network discovery on a Mac	osx
How to Capture / Post system-wide Keyboard / Mouse events under OSX ?	osx
is there a scripting solution for determining the default application path for a file on the Mac?	osx
Eclipse keyboard shortcuts broken in 10.5.6	osx
"What does this Python code do:  shell=(sys.platform!=""win32""))"	osx
Height of NSTextView with one line?	osx
Can MacOSX  group multiple NSApplications so they look like one?	osx
Race condition when calling FSDeleteObject	osx
Cocoa MAC - problem with this code using NSBundle	osx
Are there alternatives to ibtool for parsing NIB files?	osx
How do I set the icon for my application's Mac OS X app bundle?	osx
OS X counterpart to Windows' SetTimer	osx
HTTP communication monitoring on OS X	osx
Default permissions of /dev on Mac OS X 10.5.*	osx
Transfer MySQL to SQLite	osx
virtual machine player to os x	osx
developing a osx deamon that runs before user login using xcode.	osx
How to isolate causes of system hang on Unix/OSX	osx
"How to get serial number from hard disks? ""Mac"""	osx
Replace MacPorts dependency with other package	osx
How can I receive notifications of filesystem changes in OS X?	osx
How to spoof an ethernet MAC address of the wired ethernet interface coming with MacBookPro and Leopard 10.5.6?	osx
Double click document file in Mac OS X to open Java application	osx
Installing RMagick on Mac OS X with MacPorts	osx
Mutliplatform application: (Automated) Testing for Mac OSX howto?	osx
how to delete entry in content database while delete list item	sharepoint
Deploying Layouts in SharePoint	sharepoint
Customise a SharePoint List Form into Sections/Tabs/Pages	sharepoint
Different between AddRole and AddRoleDef in SharePoint usergroup.asmx?	sharepoint
Uninstall Sharepoint Infrastructure Update	sharepoint
User Profile Import - more than on Search Base	sharepoint
SPCrossListQuery fails to bring back results	sharepoint
WSS 2.0 - Creating SPSite with a user token	sharepoint
How do I run another web site or web service side by side with Sharepoint?	sharepoint
Backup and Restore SSP on MOSS 2007 fails due to missing .mdf files	sharepoint
Upload a file to SharePoint through the built-in web services	sharepoint
How to Create a Managed Path through SharePoint Object Model	sharepoint
SharePoint through Web Client Service (webclnt.dll). CreateFile fails	sharepoint
How to make an ASP.Net page with a C# code behind that will work in Sharepoint	sharepoint
SharePoint AValiablity	sharepoint
How to direct to a custom error page?	sharepoint
Review request and expiry notification emails for scheduled publishing pages	sharepoint
What is the best way to handle all SPItem's on SharePoint web Application level?	sharepoint
Feeding a SharePoint Document Library Documents Stored on a Network Share	sharepoint
"""does not contain"" in CAML ?"	sharepoint
Get Directory Path to 12 Hive programmatically	sharepoint
Creating Site Templates from MOSS publishing sites	sharepoint
How to use custom CSS with my Sharepoint WebPart?	sharepoint
How is SharePoint perceived in your Organisation?	sharepoint
How to use the SharePoint MultipleLookupField control?	sharepoint
"SharePoint ""Group By"" is broken when using ""Allow Multiple Values"" for a column"	sharepoint
In SharePoint 2007, how can I include some common items in a list, and some unique ones for each instance of the list?	sharepoint
SharePoint custom context menu in custom list appears on folders and not just files	sharepoint
provide assembly with full trust in sharepoint by custom policy level not working	sharepoint
Display separator in Sharepoint AspMenu control	sharepoint
SharePoint (WSS) Authentication Across Multiple Domains	sharepoint
development on SharePoint v.s. development on Lotus Connections	sharepoint
Sharepoint: Calculated Column replace all spaces	sharepoint
Sharepoint: How to set the permission to edit WSS user profile	sharepoint
Sharepoint Blog: lost join between categories and post when convert WebPart to XSLT	sharepoint
Sharepoint SSL Web.Config access issue.	sharepoint
Sharepoint OnWorkflowItemChanged before/after properties lists	sharepoint
CAML cannot reference Custom Properties in custom fields.	sharepoint
How can I schedule a report in SharePoint to run on the last day of the month?	sharepoint
VSeWSS problems when creating a new base class which inherits from SPItemEventReceiver	sharepoint
Handling event when approving a document.	sharepoint
Sharepoint MOSS customised v's uncustomised	sharepoint
Sharepoint - Permissions?	sharepoint
SharePoint Documentation Images	sharepoint
SharePoint error relating to page layout after creating site from template	sharepoint
One Sharepoint Feature or many inter dependant ones	sharepoint
"sharepoint permissions issues - ""Access Denied"""	sharepoint
SharePoint 2007 - How To Change Attachment Paperclip Image	sharepoint
Cannot update document property on ItemAdded event when using Vista	sharepoint
Sharepoint for a C# Asp.net Developer	sharepoint
How to update a field of type spFieldUserValue from SharePoint web services	sharepoint
Sharepoint webpart and overiding the css style	sharepoint
"Sharepoint Workflow: How do I get the ""BeforeProperties"" in a WorkflowItemChanged event handler"	sharepoint
SharePoint 2007 navigation and removing its delay	sharepoint
How to create a  dataview In Sharepoint with data from a join query?	sharepoint
Deploying New Web Parts	sharepoint
Sharepoint FBA and IIS 6.0 Anonymous access	sharepoint
Sharepoint 2007 NTLM issue with ASP.NET Web App hosted on Sharepoint server	sharepoint
How can I remotely (via web services) determine date format of SharePoint 2003 site, for use in Versions.asmx returned XML?	sharepoint
Sharepoint form layout in VB	sharepoint
Change the language of a website in Sharepoint 2007?	sharepoint
How to validate data input on a sharepoint form?	sharepoint
MVC with SharePoint	sharepoint
Outlook Webpart showing only 1 mailbox in Sharepoint	sharepoint
SharePoint - Connection String dialog box during FeatureActivated event	sharepoint
Can you perform an impersonated search in SharePoint without providing a password?	sharepoint
Different coloured fly out menu	sharepoint
How do I call a Sharepoint Webservice from a c# client using Kerberos authentication ?	sharepoint
Tracking permissions in SharePoint	sharepoint
Override SPList.WriteSecurity behaviour?	sharepoint
Custom List Definition using Document LIbrary	sharepoint
how to change default page for a site in Sharepoint using Team Definition?	sharepoint
Upgrading Sharepoint 3.0 to SQL 2005 Backend?	sharepoint
What does IAlertNotifyHandler's OnNotification() return value do?	sharepoint
How to determine if a file exists in a Sharepoint SPFolder	sharepoint
WSS 3.0 list populated from SQL query	sharepoint
SharePoint Search on default Masterpage	sharepoint
SharePoint Development Permissions	sharepoint
Can Web Parts in Sharepoint be moved outside of edit mode using drag & drop?	sharepoint
console application - object model - database persmission	sharepoint
CAML query to locate specific SPFolder nested in document library tree	sharepoint
Connect to SharePoint with WCF	sharepoint
How do you copy a file into SharePoint using a WebService?	sharepoint
How to update SharePoint Content Type?	sharepoint
Sharepoint Web Services Tutorial	sharepoint
Sharepoint workflows does not start	sharepoint
Reducted funtionality using FBA in sharepoint	sharepoint
Easy way to create a form to email in SharePoint without using infopath.	sharepoint
SharePoint Permission Levels in Production for Developers	sharepoint
Migrating from other Content Management Systems to SharePoint	sharepoint
Displaying code snippets in Sharepoint wiki	sharepoint
What can you do with SharePoint on Intranet?	sharepoint
How do I set a friendly name for SharePoint custom property enums?	sharepoint
How do I add Paging to a sharepoint DataFormWebPart?	sharepoint
SharePoint Event when Permissions of ListItems have been changed ?	sharepoint
Possible to override site creation in Sharepoint?	sharepoint
Is it possible to develop for sharepoint using continuous integration techniques?	sharepoint
Default logon-Domain for Sharepoint	sharepoint
sharepoint search with variation site	sharepoint
How do I know you have logged in a Sharepoint WebPage?	sharepoint
Get the pages of a multipage meeting workspace	sharepoint
Placing Share Documents subfolder as a webpart in SharePoint	sharepoint
Is there a way of auto-generating feature.xml files for sharepoint development?	sharepoint
Sharepoint Requirements	sharepoint
store data in a list definition sharepoint	sharepoint
Is it safe to use the Administrator Tasks in Central Administration?	sharepoint
What does the Alias attribute of FieldRef do?	sharepoint
How do I customize the confirmation email sent when a new SPAlert is created on a sharepoint list?	sharepoint
Experiences developing offline solutions for SharePoint with InfoPath?	sharepoint
How do I get a web part to refresh in IE?	sharepoint
Deployment of custom content type, forms, cqwp, and xsl.	sharepoint
SharePoint SPSite Disposing	sharepoint
SharePoint List Scalability	sharepoint
SharePoint: How can I perform a series of operations within a transaction?	sharepoint
Why does my Out of the Box SharePoint Navigation look like it is leaking memory	sharepoint
"How to force SharePoint tasks to be editable by ""Assigned To"" only?"	sharepoint
VSeWSS Administrator Privileges and <SafeControl> entry	sharepoint
Workflow with user selecting Destination doc library	sharepoint
SharePoint and deployment of global.asax code	sharepoint
Displaying the current authenticated Sharepoint user from an asp.net Page Viewer Web Part	sharepoint
What's the best way to report errors from a SharePoint workflow?	sharepoint
Is it possible to aggregate information from portal list to My Site	sharepoint
SharePoint: How to get Top 5 records by using CAML query from a list.	sharepoint
"""The selected files was not found"" on an InfoPath form in Sharepoint"	sharepoint
CAML query to add a ListItem in Sharepoint	sharepoint
"How to set ""Folders"" properties in Sharepoint View"	sharepoint
MOSS (SharePoint) publishing page schedule options not appearing	sharepoint
Create a new field and update a content type (and all implementations)	sharepoint
Add webpart to default WSS page via feature	sharepoint
IFilter dll works on Windows Desktop Search, but not on SharePoint 2007	sharepoint
In SharePoint 2007, how can I have one list displayed on two different sites/workspaces?	sharepoint
Moving MOSS Shared Service Provider	sharepoint
Sharepoint features, custom aspx pages at various site levels	sharepoint
stsadm differential backups when directories are renamed?	sharepoint
How to create a preprocessing application for indexing heavyweight formats in Microsoft Search Server 2008?	sharepoint
CAML query items with the given URLs	sharepoint
Performance data analysis in SharePoint	sharepoint
Customizing Search Results Display in Sharepoint Services 3.0 Wiki	sharepoint
How can I best create a SharePoint list view that shows only root folder contents?	sharepoint
Ceiling function in SharePoint CAML query	sharepoint
Getting properies from SharePointWebControls	sharepoint
"Sharepoint: Best way to display lists of non-Sharepoint content with ""compatible"" UI?"	sharepoint
Configuring MOSS and Reporting Services on a Domain Controller	sharepoint
Get the numerical value of an SPFieldCurrency field	sharepoint
Sharepoint: Deploy Custom Lists and New Columns in lists	sharepoint
Support for Long Running Operations using the MOSS Publishing Infrastructure	sharepoint
Sharepoint solution packaging: how do I get a custom icon for my features?	sharepoint
CMS for SharePoint	sharepoint
SharePoint/MOSS - Deleting other people's un-checked-in items from a list	sharepoint
Programatically logging to the Sharepoint ULS	sharepoint
MATLAB intersection of 2 surfaces	matlab
Matlab - having trouble with subarray	matlab
Matlab Simulink version control with multiple developers	matlab
How can I find the value of a blury image Matlab question	matlab
How to use circshift in Matlab? What am I doing wrong?	matlab
MATLAB for kids?	matlab
??? Error using ==> dlmread at 55 Filename must be a string.	matlab
Color Comparison of two images using matlab	matlab
Matlab Polymorphism question	matlab
Thread safety of Matlab engine API	matlab
Makefile Error in Matlab Real-Time Workshop	matlab
MATLAB: Reading floating point numbers and strings from a file	matlab
What does the JVM in MATLAB Compiler Runtime (MCR) do?	matlab
Matlab: Magnetic fields calculated with biot-savarts-law	matlab
Finding an approximate local maximas with noisy data in Matlab	matlab
Using find function on columns and rows in matlab	matlab
Using nntool [MATLAB] from command line.	matlab
finding the best trade-off point on a curve	matlab
convert f(x,y) to a 2-D matrix	matlab
Capitalize / Capitalise first letter of every word in a string in Matlab?	matlab
MATLAB function for 'does matrix contain value X?' (ala php's in_array())	matlab
Converting convex hull to binary mask	matlab
How to create a string array in matlab?	matlab
How do i get rid of NaNs in matlab?	matlab
Shading an area boundered by a curve	matlab
Dimension Reduction	matlab
Is there a foreach in Matlab?  If so, how does it behave if the underlying data changes?	matlab
Is there a way to call a subfunction while in cell mode in matlab?	matlab
Matlab: how to create a  cell-array in Matlab from this type of  data	matlab
Generating a list of dependencies in Matlab	matlab
matlab modem.oqpskmod	matlab
Discrete Wavelet Transformation	matlab
Anfis with sugeno fuzzy model using matlab	matlab
wavread in matlab to c++	matlab
What are you favourite Matlab/Octave programming tricks?	matlab
Pruning data for better viewing on loglog graph - Matlab	matlab
matlab precision determint problem	matlab
Problem computing a summation in matlab, seems so simple but i can't get it...	matlab
Solving Algebraic Equations Programatically	matlab
MATLAB ismember() problem	matlab
Thresholding in Matlab	matlab
Solving a determinant in matlab	matlab
Alternate method to kron	matlab
Matlab. Heart filter	matlab
Help me understand FFT function (Matlab)	matlab
Variable length MATLAB arguments read from variable	matlab
SET game odds simulation (MATLAB)	matlab
How to get name of an enumeration in MATLAB	matlab
How to show x and y axes in Matlab graph?	matlab
Reading a text file in MATLAB line by line	matlab
push a MATLAB workspace onto a stack	matlab
The Matlab equivalent of pyton None	matlab
'Array of arrays' in matlab?	matlab
accelerating Wheel - psychtoolbox in matlab	matlab
Determine location of a java class loaded by Matlab	matlab
how to select k no. of nodes with probability p(say p=0.25) out of n(say n=100) randomly generated nodes and those k nodes shown as red colored in whole figure?	matlab
Orcad / Matlab: How to plot the roots of a polynomial	matlab
How can I set I checkbox to true in a MATLAB gui?	matlab
recursive function's summation in MATLAB	matlab
MATLAB: Convert two array to a sparse matrix	matlab
getting variable values into a text string | MATLAB	matlab
Matlab and MrVista	matlab
MATLAB runs out of memory during program execution	matlab
What is the best way to flag some elements in MATLAB? using NaN or Inf? or something else?	matlab
Test if a data distribution follows a Gaussian distribution in MATLAB	matlab
How do I set a surf to one color (no gradient) in my matlab-plot?	matlab
Plot inverse colors in Matlab?	matlab
i want to use some Matlab functions via .dlls and use them in C#, pls Conduct which way i can doing that!?	matlab
Detect matlab processes from within matlab	matlab
How to create a GUI inside a function in Matlab?	matlab
Finding a certain value below the maxima in Matlab	matlab
annotation() and text() in Matlab	matlab
Batch Processing Image Files in Matlab	matlab
How to choose an input using an explorer or GUI in a matlab program	matlab
Can I unite matlab and autocad into one system	matlab
Plot graphs in MATLAB	matlab
how to plot ellipse in this format?	matlab
modem.oqpskmod -> modem.oqpskdemod not same result	matlab
Does white color has a fixed value(1 IMO) in an RGB image in MATLAB?	matlab
Neural network in Matlab	matlab
Find mode of a sequence of numbers without using arrays/vectors	matlab
matlab - How to find the image of the line at infinity corresponding to a plane?	matlab
Applying Matlab's idwt2 several times	matlab
There is a Matlab editor/plugin/version with better code completion ?	matlab
[Matlab] Saved EPS image different than plotted chart	matlab
"Saving ""heavy"" image to PDF in MATLAB - rendering problem"	matlab
Simulink: Specifying trajectory	matlab
How do I use the least squares approximation in MATLAB?	matlab
MATLAB GUI axes break window layout	matlab
Matlab: Adding symbols to figure	matlab
Matlab strcat function troubles with spaces	matlab
Tab-completion of filenames	matlab
How do I provide a username/password to access a web resource using Matlab urlread/urlwrite?	matlab
Generating vectors in MATLAB	matlab
Generate Contour Given X, Y and Z  vectors	matlab
Programmatically configure MATLAB	matlab
How to plot 2 graphics in one picture?	matlab
Multiple assignment in Matlab?	matlab
In MATLAB, what ASCII characters are allowed to be in a function name?	matlab
What's the Matlab equivalent of NULL, when it's calling COM/ActiveX methods?	matlab
Add inputs to more than one row in a structure array in matlab	matlab
Is there a better way to declare an empty, typed matrix in MATLAB?	matlab
List globals in matlab	matlab
How to read an word document in matlab	matlab
License to Distribute Matlab code	matlab
Interpolating 1D Gaussian into 2D Gaussian	matlab
"Matlab ""out of memory"" error"	matlab
How to use SIFT algorithm to compute how similiar two images are?	matlab
"At compilation, ""kamran"" was determined to be a variable and this variable is uninitialized.  ""kamran"" is also a function name and previous versions of MATLAB  would have called the function."	matlab
Problem (bug?) loading hexadecimal data into MATLAB	matlab
Changing axes and color of plots in Matlab	matlab
Calling MATLAB from C	matlab
Use Matlab cell array in a C/C++ program	matlab
"Error "" Index exceeds Matrix dimensions"""	matlab
How to use a cross validation test with Matlab?	matlab
how to apply a function to every row in matlab?	matlab
Calculating displacement moved in Matlab	matlab
matlab - creating a single dimensional array from two dimensional parts	matlab
"Prevent ""MATLAB"" folder in My Documents"	matlab
Compiling Matlab to C# Problem: fatal error C1083: Cannot open include file: 'windows.h'	matlab
calculate array element persistence algorithm	matlab
running matlab function from java	matlab
How do you output a line break in the command view in Matlab when running a m-file?	matlab
Function names and parameters in matlab variables	matlab
What's the closest thing to #define in Matlab?	matlab
How to recognize this simple capcha using MATLAB?	matlab
Show camera inputs at different axes - MATLAB	matlab
MySQL and Matlab	matlab
running script stop in the middle	matlab
How do I roll out a Matlab app for others to use?	matlab
In Matlab, how to change axis orientation?	matlab
How to change the default parameters for newfit() in MATLAB?	matlab
how to divide a spectogram into a certain number of ranges using mel filter banks using matlab???	matlab
Segmentation fault operating a camera with MATLAB	matlab
Data Classification:sizes of training and test vectors	matlab
Calculating the maximum distance between elements of vector in Matlab	matlab
matlab v.s. simulink in digital image processing?	matlab
Compiling MatLab 2009b applications to Windows Executables	matlab
Import ITK/VTK into Matlab or Matlab into VTK/ITK environment?	matlab
How do you display something from a function onto a display window in a GUI in Matlab?	matlab
How to efficiently find correlation and discard points outside 3-sigma range in MATLAB?	matlab
MATLAB help content for an abstract method	matlab
Matlab 2009b & .NET	matlab
Running code in MatLab/Mathematica only after having written it all	matlab
Get dimensions for dataset matlab, Size Function	matlab
Plotting special function (Debye) in Matlab	matlab
Matlab Piecewise Functions + Vector Manipulation	matlab
Why is this class re-initialized every time?	matlab
How to plot large data vectors accurately at all zoom levels in real time?	matlab
How to access elements of matrices  from mat file in python?	matlab
"""Pattern matching"" of algebraic type data constructors"	haskell
Equivalent of python eval in Haskell	haskell
Confusion with ContT, callCC, when ...	haskell
Proper way to import things already defined in the Prelude in Haskell	haskell
How to remove an item from a List in Haskell	haskell
Avoiding boilerplace when dealing with many unrelated types	haskell
how to iterate in snap framework without cabal install	haskell
"Translating ""Why Functional Programming Matters"" into Haskell"	haskell
Haskell, HDBC, ODBC, MySQL and Mac OS X	haskell
Parsec: backtracking not working	haskell
Looking for a web host that can handle Haskell	haskell
Which tree-based dictionary is the easiest to implement functionally?	haskell
How do typeclasses and modules interact?	haskell
Why is [String] the inferred type when there are no lists visible in the code?	haskell
Haskell Parsec items numeration	haskell
how to make Random in haskell in pure function	haskell
Iterating over arrays in haskell	haskell
What does a pipe in a class definition mean?	haskell
Cannot derive a Show instance for data containing UTCTime	haskell
How to unpack a haskell existential type?	haskell
How to match newlines with Alex/Haskell	haskell
How do I convert a variable to a string?	haskell
The Genuine Sieve of Eratosthenes -- algorithm used to generate primay numbers.	haskell
How haskell tail recursion works?	haskell
How can I initialize state in a hidden way in Haskell (like the PRNG does)?	haskell
wxhaskell asynchronous updates	haskell
haskell import problem	haskell
explain largestDivisible code from the Learn You A Haskell for Great Good tutorial	haskell
Using Data.Heap in Haskell, or reading Haskell docs for a beginner	haskell
Haskell: Gluing a char and a list together?	haskell
exposition on arrows	haskell
What are uses of polymorphic kinds?	haskell
"""type error in conditional"" in Haskell"	haskell
C compiler selection in cabal package	haskell
Quicksort + Profiling	haskell
How can I use parMap with a monadic function?	haskell
Haskell caching results of a function	haskell
Can I do something like this in haskell	haskell
Haskell - how to generate permutations	haskell
Cabal installing quickcheck version problem	haskell
Use of Haskell state monad a code smell?	haskell
In Haskell, is there (Num a) => infinity :: a ?	haskell
Strange pattern matching with functions instancing Show	haskell
Turn this recursive haskell function into a map call	haskell
Explanation of “tying the knot”	haskell
Haskell's Text.Regex.subRegex using TDFA implementation?	haskell
Haskell -- How to split a number into a list for further processing?	haskell
Name clashes between field labels of different datatypes in Haskell	haskell
Understanding Haskell's fibonacci	haskell
GHC type inference for higher rank types - assigning to monotypes	haskell
Haskell: How to write interactive interpreter on top of a State monad?	haskell
Why doesn't this type declaration work?	haskell
Which is more efficient in Haskell; pattern matching or nest if/switch statements?	haskell
Some questions about monads in Haskell	haskell
Haskell Convert Byte String To UTC Time	haskell
Multiline Matching in Haskell Posix	haskell
Instance of fractional [Char] required for definition?	haskell
Problem installing haskel-platform	haskell
Haskell: type inference and function composition	haskell
Haskell Binary Tree Function (map)	haskell
What to do with “Inferred type is less polymorphic than expected”?	haskell
Haskell on Windows Setup	haskell
How to move an element in a list in Haskell?	haskell
Pass Pointer to an Array in Haskell to a C Function	haskell
Defining multiple-type container classes in haskell, trouble binding variables.	haskell
How to get 64-bit binaries from GHC for Snow Leopard?	haskell
What are my IDE/Editor choices for Haskell?	haskell
How can I write an addition of two items in a string representation???	haskell
what is programming paradigm in haskell	haskell
Range checking in Haskell's case?	haskell
Crazy haskell indentation	haskell
Control statements in Haskell?	haskell
Haskell tail function for empty lists	haskell
newbie question: what role does the indentation play here? and Why one indent doesn't work?	haskell
Pattern matching string prefixes in Haskell	haskell
Haskell: read and type signatures	haskell
Haskell simple compilation bug	haskell
Haskell Bad Interface File	haskell
GHC refuses to export qualified modules	haskell
loop through two variable in Haskell	haskell
Haskell: difference between . (dot) and $ (dollar sign)	haskell
Haskell - mapping the odd placed values and the even placed values differently	haskell
How to handle this exception?	haskell
"Why is the recursion idiom in Haskell ""'n+1' and 'n'"" and not ""'n' and 'n-1'""?"	haskell
Haskell FlatMap	haskell
Haskell: Creating Type Classes for Zippers	haskell
Prefix form of unary operator in Haskell	haskell
Haskell: read input character from console immediately, not after newline.	haskell
Problem detecting cyclic numbers in Haskell	haskell
Haskell: How do I define the types my function can take as parameters? AND how do I access unnamed variables in a data structure?	haskell
How does Type Deduction work in Haskell?	haskell
StateT and WX gui coexistance	haskell
Haskell n-ary tree traversal	haskell
Destructuring tuples in Haskell?	haskell
Pattern matching for lambda expressions	haskell
Plot data reconstruction reading pixel colors from image files	haskell
GHCi error: Not in scope	haskell
Multithreaded Haskell	haskell
Haskell, list of natural number	haskell
In Haskell, will calling length on a Lazy ByteString force the entire string into memory?	haskell
What is [] (list constructor) *really* in Haskell?	haskell
Can you create more than one element of a list at a time with a list comprehension in haskell?	haskell
dealing with IO vs pure code in haskell	haskell
compare string contents in haskell	haskell
Problem with nesting in Text.XHtml library with Haskell	haskell
When is the difference between quotRem and divMod useful?	haskell
Haskell: type classes question	haskell
Haskell mutable map/tree	haskell
Why can't I define a new type in ghci?	haskell
Haskell: any debugShow function?	haskell
Bubble sort algorithm implementations (Haskell vs. C)	haskell
installation HDBC-SQlite3 Haskell	haskell
What does `~` means on Haskell Code	haskell
Why does Haskell interpret my Num type as an Enum?	haskell
"""Subclassing"" show in Haskell?"	haskell
How to catch arbitrary exception in Haskell?	haskell
What's the next step to learning Haskell after monads?	haskell
importing c++ data types to haskell with ffi	haskell
How do I get the values of #define-d constants?	haskell
Restricting a monad to a type class	haskell
"what is a ""Spark"" in haskell"	haskell
How to specify type for bulk list assignemets	haskell
Haskell quiz: a simple function	haskell
Matching multiple data type constructors at once	haskell
Counting elements in a tree in Haskell	haskell
Haskell -- more type inference problems	haskell
haskell: faster summation	haskell
can not get scion_server to be created using runghc	haskell
parsec-3.1.0 with custom token datatype	haskell
Haskell Input Return Tuple	haskell
Why must recursion be in a separate file in hugs?	haskell
NILL value in haskell	haskell
How do you make a generic memoize function in Haskell?	haskell
exersise in haskell	haskell
Lists in Haskell : data type or abstract data type?	haskell
How to make an instance of a generic type in haskell?	haskell
Haskell map/zip Vs. list comprehension	haskell
Creating monads in haskell	haskell
How to recursively compare the digits in a number in Haskell	haskell
Merging/union two classes into one in Haskell	haskell
How to Convert Type in Tuples	haskell
Generate syntax-colored, hyperlinked source code from Haskell or Objective-C	haskell
Haskell speculative parallel execution	haskell
Haskell Syntax case expression in a do block	haskell
Haskell: How to type cast	haskell
Defining a seemingly simple Foldable instance	haskell
Troubleusing map in Haskell	haskell
Haskell. Strict application $!	haskell
definition of filter function with foldr, in haskell. i want to see if i understand how it's working.	haskell
How long does it take for you to be comfortable with Haskell?	haskell
Tagging Posts via Wordpress XMLRPC	wordpress
CSS not rendering on MAMP	wordpress
Blog wordpress-moveble type	wordpress
Wordpress [caption] processing	wordpress
What kind of Plugin is the New Playstation Share Blog using | Wordpress	wordpress
Wordpress blog page	wordpress
How to Display Comments to a static page	wordpress
Display Link to Category in Wordpress?	wordpress
"Wordpress, when using the ""comment_text"" action is it possible to get commenter information?"	wordpress
How do you get a commenter's email address from a WordPress cookie?	wordpress
Change wordpress navbar to link straight to post or page	wordpress
Wordpress dynamic navigation function for highlighting single post tabs	wordpress
Wierd date and time formating in Wordpress %Y/%m/%d	wordpress
How was my WordPress site hacked?	wordpress
How to login to wordpress programmatically?	wordpress
wordpress: how to get x youtube thumbnails of my youtube account ?	wordpress
Wordpress Theme Demo	wordpress
Developing an Application using Wordpress as a base?	wordpress
How can other users be updated when a comment is posted, other than the author in wordpress?	wordpress
Wordpress - Harvard Gazette - How did they do X ?	wordpress
How do I get ALL posts in a category with Wordpress?	wordpress
WordPress Child Theme	wordpress
Lighttp and wordpress URL rewrite	wordpress
Sidebar Behaves Differently on Wordpress Archive Pages	wordpress
Extending Wordpress as a full-scale CMS	wordpress
Why is WordPress considered to be poorly programmed?	wordpress
How to determine if Wordpress plugin is called from Wordpress widget	wordpress
Configuring wordpress .htaccess to view subfolders	wordpress
URL regex search and replace on MySQL (in WordPress)	wordpress
"What are pros and cons to use ""wordpress theme framework"" instead blank theme?"	wordpress
Wordpress: How to create a video gallery in wordpress?	wordpress
How do you make a WordPress front page template in the Carrington blog theme?	wordpress
WordPresss Plugin Development	wordpress
Changing paths to images in Wordpress	wordpress
Overwriting a core Wordpress function - should work but it doesn't	wordpress
WordPress extreme oddity with broken images	wordpress
WP Function to retrieve database connection	wordpress
Using wp_query to pull content from a specific post using either title or id	wordpress
Used MacPorts to install WordPress. Where is it now?	wordpress
Wordpress Hook Pre Post Update	wordpress
How to make a post to wordpress using the api?	wordpress
Thousands of instances of index.php opening at the same time	wordpress
Wordpress retrievig Post children	wordpress
Wordpress the_time formatting	wordpress
How can I work with paragraphs in Wordpress?	wordpress
Is the syntax for the Wordpress style.css template element available anywhere?	wordpress
Finding the Latest Post by Author	wordpress
How to Build WP Site with Hierarchical Content and Using Custom Design?	wordpress
Wordpress Authenticate Filter	wordpress
Inserting a custom_field in Wordpress using MySql	wordpress
word press plugin	wordpress
Want to learn Plugin/Template Development. Wordpress or Joomla?	wordpress
Wordpress excerpt - image and text	wordpress
how to add image to each category in wordpress?	wordpress
Query to show images with recent posts in Wordpress sidebar/widget	wordpress
Inserting Wordpress Plugin content to posts	wordpress
mod_rewrite, put wordpress in sub-dir on server seamlessly?	wordpress
Wordpress blog setup script to create about, contact, privacy pages	wordpress
Wordpress previous_posts_link() leads to a 404 error not found	wordpress
wordpress: add the categories to a post rss title	wordpress
Wordpress - automatically creating page	wordpress
Wordpress: How do I convert a generated URL (permalink) to a pretty URL?	wordpress
ajax wordpress posts	wordpress
Wordpress database backup	wordpress
Wordpress and MySQL Collations	wordpress
"How do i build a custom ""Your Account"" dynamic page with wordpress?"	wordpress
Remove gap in wordpress posts in IE	wordpress
WordPress Database Backup Question	wordpress
Can I have both full text RSS and an excerpt RSS in Wordpress?	wordpress
Wordpress admin section cleanup?	wordpress
Using a custom URL parameter in Wordpress (with permalinks)?	wordpress
How to posting to WordPress using C# ?	wordpress
Is it legal to remove link to Wordpress' site?	wordpress
How do I hook into the Wordpress login system to stop some users programmatically?	wordpress
Word press - Changed directory and images do not appear	wordpress
Managing Wordpress blog on development and live environment	wordpress
Is There are a Way to Write just Next/Prev Post Link on Wordpress?	wordpress
Wordpress: Two different Permalinks for same Blog	wordpress
Wordpress Data Storage Efficiency	wordpress
Wordpress how to prevent category and archive crawl and index	wordpress
Thickbox problem - appearing at bottom of page	wordpress
Can two different sites running on same host, share same database for storage and retrieval?	wordpress
How to hide Wordpress upgare message in Admin Panel ?	wordpress
Getting Theme information from the style.css file in Wordpress	wordpress
How to use term_group for ordering subcategories in Wordpress?	wordpress
Differentiating between P tags wrapping images and P tags wrapping text nodes in Wordpress?	wordpress
Wordpress Prevent Users from posting full size image uploads	wordpress
wordpress multiple loops problem	wordpress
Facebook updates posted to wordpress blog.	wordpress
List wordpress sub-pages as drop-down list in navigation	wordpress
Overcome Wordpress Memory Exceeded Limit, WITHOUT changing server's limit.	wordpress
I need to block my feed completly	wordpress
Wordpress not working when using Apache virtual hosts	wordpress
I want my wp 2.8.6 blog to be seen as written in Spanish by Feedburner.	wordpress
How does wordpress password hash work?	wordpress
"WordPress > Calling ""Recent Posts"" widget via script from custom theme"	wordpress
Password Protected Wordpress MU	wordpress
Updating your blog from a localhost version	wordpress
Wordpress display specific sub category of a parent category.	wordpress
wordpress: actions, filters & hooks	wordpress
Dummy blog entries for Wordpress theme development	wordpress
How to tell Wordpress category page to call specific sidebar	wordpress
"Wordpress ""Read more"" is not working"	wordpress
Getting plain HTML/CSS versions of Wordpress themes, no PHP?	wordpress
WordPress - Each page of paged posts all show same posts	wordpress
Wordpress static home page dynamic posts page url rewrite	wordpress
How do I order subpages within my static ones in Wordpress.org 2.8.4 ?	wordpress
How to display a list of wordpress authors in a dropdown, with a link to the author template?	wordpress
Migrating Wordpress Site from subdirectory to root. Problems!	wordpress
Wordpress nav not visible in pages like articles, blog & search	wordpress
Wordpress support	wordpress
wordpress custom function for tabs creating duplicate tabs - simple php!	wordpress
CSS breaks in Explorer (insert humor here)	wordpress
Where to start with Google Reader as an API?	wordpress
Use post tags for meta keyword content	wordpress
How to set Wordpress and index.php to WP site	wordpress
"How to get and display post's ""position"" in the query?"	wordpress
Add Comment and Reaction Count in Wordpress with Disqus plugin	wordpress
Wordpress Page order	wordpress
Wordpress database migration	wordpress
Hiding a DIV in sidebar in Wordpress	wordpress
Why aren't jQuery and cycle working in Wordpress?	wordpress
What php code do I need to get text from wordpress text widget?	wordpress
Wordpress: How to set default (active) theme via script	wordpress
Creating dynamic region content in wordpress as in drupal	wordpress
Wordpress theme not displaying when activated on production server, but will display on development environment	wordpress
With wordpress, is there a statement like current_user_can except show something if a user does not have specific access?	wordpress
"debuging ""register_activation_hook"" in wordpress"	wordpress
Wordpress : template tags get_page()	wordpress
Wordpress - Get Post Number in a Category	wordpress
Change the date of wordpress	wordpress
Query multiple custom taxonomy terms in Wordpress 2.8?	wordpress
WordPress query posts into two Divs	wordpress
What is the right way to modify a wordpress query in a plugin?	wordpress
Can't get wordpress feed to display full article...	wordpress
How to auto activate WordPress widgets? (New Widgets_API WP_Widget class)	wordpress
How to check whether a particular widget is show or not in the sidebar ?	wordpress
Change input value on Wordpress' get_search_form()	wordpress
trying to find the comment hook I need for wordpress?	wordpress
wp_list_categories does not show current category	wordpress
Move wordpress from home web server to web server hosting account	wordpress
Replace css file for Topsy wordpress plugin	wordpress
How do I get the WordPress sidebar to show up on a post's detail page?	wordpress
wordpress permalink post_type	wordpress
Wordpress: Find posts in category 1 and not in category 2	wordpress
Setting A Header Image for a Wordpress Page and all its children	wordpress
WordPress: Assigning widgets to individual pages	wordpress
Easy Way to Find Images Used in a Wordpress Post?	wordpress
Get WordPress Post ID from Post title	wordpress
Wordpress Seo features	wordpress
How to Configure SSL over Database in Spring?	spring
@Autowired and TransactionProxyFactoryBean?	spring
How do you authenticate against an Active Directory server using Spring Security?	spring
Referencing beans in xml config created via Annotations	spring
How to Debug Spring NoSuchBeanDefinitionException	spring
springdoclet usage?	spring
Best way to cache persistent data (e.g. code books) in Spring?	spring
how to send mail Spring implemention using gmail smtp?	spring
Spring programmatic transaction with parameter	spring
Spring Map a file to a Url / URI	spring
What is the best view layer for Spring 3 ?	spring
spring portlet MVC and request params	spring
view is not rendered when returning ModelAndView	spring
annotation based Spring bean validation	spring
Resource Bundle Spring	spring
Spring and the scope attribute	spring
Getting access to a spring bean from a webservice?	spring
Spring MVC Date and CustomDateEditor problem on simple text Field.	spring
Problems overriding a property to null in Spring bean declaration	spring
"The prefix ""security"" for element ""security:http"" is not bound"	spring
Spring web application: executing common code before entering RequestMapping in controller	spring
Does Acegi/Spring security support getUserPrincipal()?	spring
Trying to get the information of session WebFlow Spring	spring
How to use Spring to inject an object in a setter that doesnt follow the Java bean specification ?	spring
how does a spring framework works?	spring
SPRING: What is AOP, Dependency Injection and Inversion Of Control in Simple English	spring
How to programatically use Spring's JdbcTemplate?	spring
getting value from one controller to another controller	spring
g:set blocks out my code	spring
spring batch insert using hibernateTemplate, JdbcTemplate	spring
How to know which URLs are mapped in the current servlet context in a Spring 2.0 Controller method?	spring
Spring + Thread safe singletons	spring
Disable Spring URL resource loading in context file	spring
Can Spring Webflow 2.0's entity manager commit from subflow states?	spring
Jersey, Spring, Tomcat and Security Annotations	spring
Spring: Programmatically use PropertyPlaceHolderConfigurer on none Singelton Beans	spring
Using single spring application context for web app	spring
Spring validator default message codes not resolving	spring
Spring Hello World setup and code in eclipse	spring
Hidden features of Spring framework ?	spring
Spring roo Vs (Wicket and Spring)	spring
Making sure a Spring Bean is properly initialised	spring
Use of getBean as opposed to method injection in Spring	spring
Getting server name in ContextLoaderListener	spring
Using Spring by Creating Multiple ApplicationContexts to manage bean life time - is this okay?	spring
DefaultAnnotationHandlerMapping via ContextLoaderListener instead of DispatcherServlet on Spring 3	spring
How do I get spring to inject my EntityManager?	spring
Spring- How to use Springs Dependancy Injection to write a Standalone Java Applicaiton	spring
@Secured()      is there any statement show on log...?	spring
How can I configure Spring to save as much memory as possible?	spring
Jar utility for the Java package org.apache.poi.hssf.usermodel.*	spring
java logging vs Log4j in Spring framework. Which one is the most suitable.	spring
com iplanet AsException when trying to instantiate spring bean outside container	spring
auto-detecting components using spring annotations	spring
Multiple messageSources in Spring configuration files	spring
Infinite loop using Spring Security - Login page is protected even though it should allow anonymous access	spring
ETL , Esper or Drools?	spring
How to update a postgresql array column with spring JdbcTemplate?	spring
What are the design patterns which used in Spring framework?	spring
Is there an equivelant to spring's ContextLoader for a non-webapp	spring
Is there an example on how to use Spring 3.0 content negotiation for RESTful services?	spring
spring session scoped bean value empty?	spring
Cannot use Spring LDAP with Spring Security	spring
Why does Spring's @Configurable sometimes work and sometimes not?	spring
Spring MVC and parsing HTML	spring
Spring Custom Filter Problem?	spring
How to nest Spring JMS MessageConverters	spring
Introducing Spring MVC	spring
Multiple servers checking and writing flag in database	spring
Spring MVC and JSF navigation rules together	spring
Simple autosave for Spring MVC form	spring
Automatic configuration reinitialization in Spring	spring
How to implement pagination is spring mvc 3	spring
Caching with Spring Framework	spring
Eclipse Spring Builder set properties with Groovy beans	spring
Parent Contexts in spring based web-app	spring
Basic Spring help	spring
setting a property in a spring bean outside the spring bean definintion.	spring
Narrowing problem with Spring MVC annotation-based controller and @RequestMapping	spring
what do the terms formBackingObject and ModelAttribute mean in Spring MVC?	spring
How to programmatically add Security to a Spring Bean	spring
JPA Multiple Persisrtence Unit [bug]	spring
Spring - share web application context between different webapps	spring
Is there any difference between Spring and Spring.net?	spring
How to use a Spring config file in a Maven dependency	spring
Compile classfile issue in Spring 3	spring
duplicate spring configruations being loaded?	spring
HibernateTransactionManager(Spring) with multiple Session Factories	spring
How can I access the ApplicationContext from within a JAX-WS web service?	spring
Hibernate/Spring: Persisting collections	spring
EntityManager injection with JPA	spring
Spring + SOAPExceptionImpl: Error during saving a multipart message	spring
Spring webflow validation	spring
Spring 3.0M4 and passing objects as parameters to POST	spring
spring xml config	spring
How do I write StoredProcedure sub-classes to call Oracle functions?	spring
how to manage a custom user object in session when spring security autheticates user.	spring
Example of Spring missuse	spring
Is there a spring lazy proxy factory in Spring?	spring
Minimizing SpringLdap dependencies.	spring
Custom Spring sterotype annotation with scope of prototype?	spring
Spring XML inner bean question	spring
image uploading using MultiPart	spring
What applications do i need to download to start developing apps using spring framework?	spring
Define DAOs in spring when the datasource is varying dynamically	spring
Anybody using Qi4J	spring
SpringJUnit4ClassRunner tests -- work from ant, not from IDE	spring
Slow to start after upgraded to Spring 3	spring
using Spring JdbcTemplate	spring
Is there a good reference for how Grails was architected with Spring?	spring
Testing simultaneous calls to transactional service	spring
Integrating Spring Webflow 2 and Apache Tiles	spring
Accessing legacy out-of-container instantiated objects from Spring beans	spring
Error creating bean with name 'sessionFactory'	spring
What Spring exactly is for?	spring
accessing HttpServletRequest object in Spring WebFlow	spring
What class should I inherit to create a database integration test in case of Spring?	spring
Spring Unit/Intergration Testing setup	spring
Spring MVC binding parameters to backing object	spring
Getting Exeception	spring
Spring 3.0: Unable to locate Spring NamespaceHandler for XML schema namespace	spring
does spring provide 2 mvc platforms, grails and spring mvc?	spring
Spring MVC Table selected row	spring
Compiling jasperreports automatically on change	spring
How exactly JdbcTemplate with TransactionManager works together?	spring
Spring - How 'multiple' AOP behaviors to sevices are resolved?	spring
Issues with setting URL mappings in Spring MVC 2.5	spring
File based Spring Security	spring
How to create an aspect on class, that is not a bean using Spring AOP?	spring
Spring - How do you set Enum keys in a Map with annotations	spring
Spring Transaction - Proxy confusion	spring
"Spring Security OpenID - Unable to Process claimed identity ""null"""	spring
How can I define multiple sessionfactory instances in Spring?	spring
"How to ""white label"" spring beans"	spring
Easiest way to add GWT to a Spring MVC application?	spring
"How to make Jetty dynamically load ""static"" pages."	spring
How to create a custom EL expression handling regime for jBPM	spring
Dependency Inject by type using generics - how does it work?	spring
SpringSecurity : always redirect logged in users to a page	spring
Spring - When should I consider loading another context in same JVM?	spring
What causes a Spring 1.2 NullPointerException when creating prepared statement?	spring
different using @Transactional and spring template ?	spring
Spring Application Context available inside the constructor	spring
Convert Spring Batch from 1.1.3 to 2.0.0	spring
DAO, Spring, Hibernate, Jboss	spring
Spring 3.0 - Unable to locate Spring NamespaceHandler for XML schema namespace [http://www.springframework.org/schema/security]	spring
How to restart transactions  on deadlock/lock-timeout in Spring?	spring
Why Spring Framework ?	spring
Interoperability by using Spring and Hessian ? Is it possible ?	spring
Spring security and Struts 2	spring
Magento, add Clothing size attribute without Configurable Product	magento
Magento: Extending a community module	magento
Magento Community: Product / Category Images do not upload	magento
Magento Template Variables	magento
remove particular order status from list in magento	magento
Authorize.net Wrong Merchant Type From Magento	magento
how to get store information in magento?	magento
Best way to link Category to customized Modul	magento
"Having ""Minimal Price"" display issues within assigned category."	magento
Is this normal Magento memory behaviour	magento
Magento Store - Horizontal Items in Grid	magento
Magento: output an attibute as a link	magento
Where is the setCouponCode function is defined in Magento	magento
different template for different categories in magento	magento
Run Magento in the future!	magento
Magento 1.3 or 1.4	magento
how can i get category detail on shipping.php page in magento	magento
redirect to a particular page after contact form is submitted in Magento	magento
Magento - determine which xml layout file a page is using?	magento
Magento: getting an attribute of a nav filter item	magento
Bringing in value of Coupon Code into calculation.php in magento.	magento
Magento - add percentage on top of calculated price	magento
Magento discount coupan code created on fly but not working properly.	magento
How long do the magento session files need to be kept?	magento
"""Log In"" and ""My Account"" have vanished from Magento top-links"	magento
override save and load of an attribute in magento	magento
Adding mini-login box in Magento	magento
How to use Server Side Includes in Magento Description?	magento
magento 1.3.1 undefined alert error	magento
"Removing the block ""Popular Tags"" from the index view in Magento"	magento
How to get sales volume of product in front-end?	magento
magento newsletter not posting	magento
Magento - Retrieve products with a specific attribute value	magento
magento installation	magento
magento how to disable image zoom	magento
How to add grid in Magento edit tab?	magento
Magento XML layout	magento
How to override a Magento administration panel?	magento
How to filter a product collection using 2 category filters?	magento
Magento: Change default product image with PNG	magento
Differentiating Backend vs. Frontend Purchases in Magento	magento
Magento Connect is not working after migration	magento
price filter problem in magento	magento
How do you find the block of code you are looking for in Magento?	magento
Magento - Display Same Block Multiple Times on CMS Page	magento
Magento from 1.3 to 1.4	magento
Magento Admin login kicks me out back to the Admin login	magento
Help with Magento and related products	magento
How in magento add manufacturer in the URL of the product?	magento
Is it possible to customize magento admin area	magento
adding price rules to magento products	magento
Magento Store - Add nofollow to Layered Navigatio	magento
Magento - How to rewrite /app/design/frontend/default/default/template/customer/form/register.phtml	magento
i install Magik_Featuredproducts component in magento after install i can't access my adminpanel and front view ?	magento
Magento - Difference Between Import All Products/import Product Stock?	magento
Is it possible to target just Simple Product from phtml template?	magento
Magento: Disecting the Default Theme	magento
Using Magento with a simple one-product site	magento
Update Store Logo Programmatically Magento	magento
Magento get number of products for a price range	magento
How do I create custom fields like mobile number  in customer registration form  without modifying  magento core files?	magento
Magento Store - Extensions Breaking Admin	magento
Magento - removing wishlist link in 1.4.2?	magento
I have simple design and need to put it on magento	magento
Not able to check if user is logged in magento system in footer.phtml file on some pages	magento
Add a date picker to system.xml on custom module	magento
Magento - Code Question	magento
Adding new column in Sales Order View Items in Magento Admin	magento
inserted  custom option not displaying only displays after refresh	magento
"magento ""gender"" default option need change"	magento
Magento - using $this->getPriceHtml on custom page template	magento
Magento - Simple Configurable Products Extension question?	magento
Magento - List Products Categories	magento
Automatic mail alert to customers on new products arrival in magento	magento
Magento 1.4 - new order email notification not beign sent	magento
custom shipping in magento	magento
How do I get product category information using collections in Magento	magento
Get product link from Magento API	magento
Display a menu with categories, sub-categories and products - Magento	magento
How could I cache images that I'm pulling from a magento database through ajax?	magento
"Magento: Add a ""fake"" product to cart/quote"	magento
Displaying all attributes on the simple product table of a grouped product - Magento	magento
map marker on Unirgy storelocator in Magento	magento
adding image to the widget of magento	magento
magento cross selling subcategory	magento
display items from another site in my web site using Magento	magento
How to setup a Magento rewrite rule that keeps it's GET parameters	magento
Filter Magento collection but not products, using distinct	magento
Magneto discount  coupon code set but value is not subtracted  from subtotal...	magento
Magento CMS pages - getting title from URL key?	magento
How to redirect to an action in Magento?	magento
Magento Installation Information	magento
Magento: Several custom blocks all outputting the same code!	magento
How do I add per item personalisation options to the cart page of Magento?	magento
Magento : Converting currency before sending data to Google Checkout	magento
How to use separat block caches for secure and unsecure shop access in Magento?	magento
Problem:fetch product URL in a custom Module: Magento	magento
change default grid columns in Magento catalogue	magento
How can I reset addAttributeToFilter in Magento searches	magento
Magento Installation Problem	magento
Invoice for 2 or more orders in magento	magento
Magento development	magento
Magento - Echo Attribute on Product Page	magento
import csv/excel file into magento database	magento
Magento - zend - backend error	magento
How to get a list of product categories and their ID's from Magento?	magento
"How to call portions of Magento into an external CMS, such as ""item's in cart"" or a ""login form"" in 1.4."	magento
Magento image upload problem ....	magento
How to import images into magento using an absolute path?	magento
Magento - Add CMS Block to One Page	magento
Magento 'loses' categories when entering a subcategory.	magento
Magento - page title on contact page	magento
Downloading invoices (PDF) does not complete.	magento
Magento checkout.xml file not being recognised	magento
Magento My Account Layout XML Problem	magento
How can I filter a product's availability using isSaleable attribute?	magento
magento getCollection() can we put where condition?	magento
can a magento adminhtml field depend on more then one field or value?	magento
Product options and Add To Cart button don't appear on some pages in Magento	magento
export products to csv from the admin product grid	magento
magento database structure ????	magento
Magento - blank lines being added to wsdl file	magento
Magento DataFlow Integration and Module Development Resources?	magento
Embedding search results (or tagged products) in a Magento CMS page	magento
"Magento ""My Account"" link section"	magento
Magento: How to tell if you're on a category page, or product page in .phtml file(s)	magento
Magento - where's the php file subscribe.phtml calls once the form is submitted	magento
Magento - Have different set of fields and labels for cart and checkout (order review) screens	magento
Magento - Singole cateogry on sidebar	magento
magento payment methods - enable for admin only	magento
Magento: Differences between an extension and a module?	magento
What changes do I need to make Magento work with PHP 5.3?	magento
Magento - change address to which confirmation is sent after newsletter subscription	magento
Magento; dispatch multi store	magento
Magento - Submit anf get variables between 2 blocks	magento
Linking Simple product to their page listed under Grouped product in Magento	magento
Paginating a long list of checkboxes in Magento	magento
Problems loading a configurable product in Magento	magento
What is the best way to limit a modules functionality by store or website	magento
Integrating Magento with SAP ECC 6.0 Backend	magento
add custom field to subscribtion module in Magento	magento
new page in backend in  magento	magento
Magento - how to include javascript file on a page by page basis	magento
$item->getProduct()->getQty not working in magento	magento
Magento custom attributes failing to install	magento
How to Create a Downloadable Product through Magento API?	magento
Magento: Select the top ordered products	magento
Cannot access new product attributes in grid display	magento
magento insert product list for category 18 under cart	magento
Why is Magento trying to call in the Mage namespace rather than my custom namespace?	magento
Assembla no longer free!! :(	svn
svn rename problem	svn
external library update in a SVN repository	svn
How to access the current Subversion build number?	svn
How do I view all ignored patterns set with svn:ignore recursively in an svn repository?	svn
SVN update command to target a single externals subfolder ?	svn
How do you setup a shared Working Copy in Subversion	svn
Recovering from a slightly out of date subversion repository backup	svn
Where is the Attic in Subversion?	svn
How do you remove a file from being version controlled without deleting the file in subversion?	svn
if i have Windows, Mac, and Linux, what is the easiest way to set up SVN server?	svn
What stratagies are best for storing art assets in SVN?	svn
Which is more popular (currently, by recent install base) SVN or CVS?	svn
how do I integrate a branch into a trunk if the folder structure has changed?	svn
good stand-alone svn client	svn
In Subversion can I be a user other than my login name?	svn
Apache, SVN and mod_python	svn
SVN diff across 2 different repositories	svn
Migrating complex SVN branch hierarchy to Mercurial	svn
How do you deal with configuration files in source control?	svn
"""svnlook changed"" encoding"	svn
Integrating External Sources in a Build	svn
Commit changed files, added new files and omit some files to an external server in Subversion on Linux / Ubuntu	svn
How to get a list of all SVN commits in a repository and who did what to what files?	svn
how do I create a dump file from my subversion hosting account?	svn
svn checkout and update without the .svn directory	svn
Will Subclipse 1.4.4 work with Subversion 1.3.2	svn
.NET projects build automation with NAnt/MSBuild + SVN	svn
using subversion with a really really big site	svn
Moving from VSS to SVN	svn
How are tags made in Subversion?	svn
SVN Libraries for .NET?	svn
Why would subversion timeout when I try to commit changes to a directory?	svn
Can pysvn 1.6.3 be made to work with Subversion 1.6 under linux?	svn
Easy way to embed svn revision number in page in PHP?	svn
Synchronize SourceSafe with SVN	svn
Using svnversion with svn:keywords	svn
Removing irrelevent directories with SVN	svn
Reorganizing a subversion repository with branches	svn
Check that an svn repository url does not exist	svn
Best tools for code reviews	svn
"svn changelists: how to limit operations to ""default"" changelist?"	svn
Hosted subversion recommendations or suggestions	svn
Creating symbolic links to branches in SVN?	svn
Migrate from Subversion to Team Foundation Server	svn
How to undo removal of a file in svn	svn
"cvs2svn fails with ""xxx is not a valid ,v file"""	svn
Handling and syncing own custom version of an open source library with SVN	svn
what is the best way to back up an SVN server for all the code and content?	svn
Should the WebInfo file be excluded from SVN	svn
excluding commits by specific users from svn merge	svn
SVN: Track merges	svn
Can someone explain source (versioning) control to me?	svn
How do I branch an individual file in SVN?	svn
Putting Subversion Repositories in Subdirectories?	svn
What Subversion distributions are suitable for an enterprise	svn
Are subversion externals an antipattern?	svn
SVN Doubt - VMWARE Image / Install / Hosted which would you pick?	svn
Do you have to have branch, tag and trunk folders for an SVN repository?	svn
SVN 1.3 VS 1.5 (latest)	svn
How to forbit subversion commits to svn:external to revisions?	svn
How do I use the new SVN merge-tracking?	svn
SVN Manager App for Mac (better than XCode)	svn
Relative Path in Subversion external configuration	svn
Svn full dump (moving servers)	svn
How to set an svn repository path to a server path?	svn
SVN: a versioned directory of the same name already exists	svn
How do I simultaneously work on version 1.1 and version 2.0?	svn
Collabnet SVN Log files, are there any?	svn
Same working copy of the code with 2 SVN servers.	svn
Using subversion for web applications	svn
List all svn:externals recursively?	svn
How can I change the commiter of an old revision in SVN	svn
Why does authorization fail when I commit to svn using VisualSVN?	svn
How would you set up an Subversion repository for in house software projects	svn
How can I query my subversion repository?	svn
Merging missed changes in Subversion	svn
use svnant without a username or password	svn
Which do you like - Visual SVN or Ankhsvn?	svn
Subversion - where should the svn:externals come from?	svn
How do I prevent a subversion user accessing part of the repository?	svn
Excluding subdirectories with a pattern in subversion	svn
checkout svn+ssh with loginname	svn
"What does the Subversion status symbol ""~"" mean?"	svn
how to change the subversion directory usingg eclipse	svn
Subversion creating revision directories with too-strict permissions	svn
Is it possible to get a list of added or deleted files from subversion?	svn
Connect to my Repository remotely using TortoiseSVN	svn
SVN Branching in Eclipse (Conceptual)	svn
Access denied  Tortoise SVN 64 bits	svn
SVN admin management GUI tool	svn
Where to find prebuilt binaries for subversion 1.6 for Ubuntu (or Debian)?	svn
Authentication Subversion write-through proxy	svn
Tips for using CVS or Subversion as a backup framework for office documents	svn
SVN Won't download newly added files	svn
SVN - How to set all files to same revision number and date.	svn
How do I browse an old revision of a subversion repository through the web view?	svn
interoperation between mercurial and subversion	svn
svn stumbling blocks	svn
SVN: How to re-create a directory that's created but not committed yet	svn
How to setup a Subversion (SVN) server on GNU/Linux - Ubuntu	svn
Best source control package	svn
SVN recursive delete	svn
Getting the last revision number in SVN?	svn
Excluding a single project file from an SVN repository	svn
svn + repostiory location	svn
How do I add a file to Subversion that has the same name as a directory that was deleted?	svn
SVN replicate directory	svn
Viewing repository information from within Eclipse, when code was checked out using svn tortoise	svn
Personal Version Controller	svn
With svn how do I add a log message to trunk when creating a tag?	svn
Any disadvantages of accessing Subversion repositories through file:/// for a solo developer?	svn
How can I retore svn control if the .svn folder has been damaged	svn
Only trigger a build on commits to the trunk with svn	svn
Subversion - Merging Repositories	svn
Does ClearCase fit our development process?	svn
Installed Visual SVN Server, except I get this message when do SVN Check Out	svn
Best general SVN Ignore Pattern?	svn
Should I add compiled DLLs to my subversion repository?	svn
Automating builds from subversion tags	svn
SVN management on a project that uses absolute paths.	svn
Changing SVN Repository	svn
SVN\Tortoise painfully slow	svn
After setting up the svnserve Server, what URL will the client use to access the server?	svn
How do I search all revisions of a file in a SubVersion repository?	svn
Failing to ignore svn-controlled directory when doing svn update	svn
Importing an svn branch into git	svn
How big of a security risk is checking out an svn project right into production site?	svn
Best practice for creating subversion repositories?	svn
How can I manage merging updates from several developers?	svn
how to track multiple svn branches in git	svn
Synchronize SVN through FTP	svn
SVN : Get All Files From A Revision	svn
Local copy of SVN repository, syncing to remote copy?	svn
Subversion branch question	svn
Is there an svn command to remove files from the client only?	svn
In Subversion, is it possible to merge back changes made in a branch of a branch?	svn
How to make a private branch of public SVN repository?	svn
methods to store binary files in SVN	svn
What are the uses of svn copy?	svn
SVN how to resolve new tree conflicts when file is added on two branches	svn
How do I properly remove an svn:externals and replace it with a local (non-external) copy of the same directory?	svn
TortoiseSVN compatibility mode	svn
SVN plugin for VS2008	svn
To host or not to host?	svn
Svnserve VS mod_dav_svn	svn
SVN checkout or export for production environment?	svn
svn revision number	svn
SVN Pre Commit Hooks	svn
Differences between SVN and SVN+SSH on a Windows SVN server?	svn
setTimeout not working in javascript	ajax
Does PartialView do what I think it should (but doesn't)?	ajax
Ajax Assembly Error - Assembly {0} does not contain a Web resource with name {1}	ajax
Best practices for getting cross-site JSON responses to POST?	ajax
How can you use ajax within an object to populate the object's instance variables?	ajax
Ajax Response from  CGI program	ajax
How to test an AJAX application that is pulling data from a live website?	ajax
AJAX readystate	ajax
Make web application with ajax from the begining or add ajax later?	ajax
AJAX jQuery.load versus jQuery.get	ajax
onreadystatechange function not being called	ajax
NHibernate + JSON/Ajax Parent/Child Relationships? Why no workie?	ajax
Best practices for handling a web service failure	ajax
Sending login information via AJAX	ajax
How to display a message on screen without refreshing like SO does?	ajax
ajax success event not working	ajax
jquery ajax not setting variable to POST	ajax
Ajax request returns a 404 but URL works fine	ajax
Don't mix Response.Write with AJAX, but what about UI.HtmlTextWriter?	ajax
ajax and codeigniter duplicating header	ajax
call a method with jQuery AJAX	ajax
What is the most convenient way to stop an Ajax-object in prototype from swallowing exceptions?	ajax
How to make XMLHttpRequest  work over HTTPS on Firefox?	ajax
Ajax Popup alert	ajax
Comet applications without using IFrames	ajax
Access denied | uncaught exception in FF 2.0 | servlet call from another host	ajax
googlemap-like drag and zoom	ajax
xmlhttprequest onlys gets to status 3	ajax
Does the iPhone has AJAX and jQuery support?	ajax
Set timeout on jQuery .load	ajax
AJAX and NS_ERROR_DOM_BAD_URI error	ajax
Problem running my project in IE 6.0 and 7.0 (window.location)?	ajax
Ajax-driven complex layout RIAs and mvc frameworks	ajax
jquery and ASP.Net AJAX framework	ajax
Not Ajax-related controls in AjaxControlToolkit?	ajax
Returning Json data from Orchard Controller using Jquery Ajax	ajax
ASP.NET MVP and AJAX posting/webservices	ajax
How can I use jQuery AJAX to update my Gridview?	ajax
Ajax jquery synchronous callback success	ajax
AJAX readystate breaking, AJAX not processing data fast enough?	ajax
ASP.NET JavaScript Callbacks Without Full PostBacks?	ajax
AJAX Library Strategies	ajax
"Why have ""while(1);"" in XmlHttpRequest response?"	ajax
HTML Form/Database query	ajax
how do you screen scrape ajax pages ?	ajax
how to populate dropdown with dynamic date based on 2 other dropdown boxes	ajax
ajax library that populates multiple fields	ajax
how to retrive data from MySQL using javascript	ajax
Dynamic UI styling/theming	ajax
How do I send a cross-domain POST request via JavaScript?	ajax
howto create an Ajax Popup Form and submit the form	ajax
Which Javascript Ajax Framework is most powerful and very lightweight?	ajax
A popup in an Modal window to replace JS confirm and alert - ASP.NET	ajax
IE doesn't wait for result of $.post(	ajax
Access denied problem in AJAX	ajax
Load content into parent element with jquery	ajax
sharing mysql conntection between php files	ajax
Ajax chat polling bandwidth efficiency.	ajax
AjaxControlToolkit Accordion and databinding	ajax
Recommendations for simple AJAX?	ajax
Ajax page part load and Google.	ajax
Multiple responses from one AJAX request	ajax
How to upload a file using asp.net without posting the whole page back?	ajax
AJAX style uploader	ajax
How to know when all ajax calls are complete	ajax
javascript - Want to access the contents of another domain with ajax?	ajax
MS Ajax Toolkit now on backburner?	ajax
strange javascript form behaviour.	ajax
Reverse Ajax without Comet?	ajax
How to make all AJAX calls sequential?	ajax
How do i submit an ajax request before the page is loaded	ajax
Basic AJAX example with ASP.NET MVC?	ajax
Getting wordpress to play nice with AJAX	ajax
JQuery ajax error function is executed even if query is successfull	ajax
"Best Language for an AJAX-driven ""Reputation Index"""	ajax
Problem uploading a file via ajax using PHP	ajax
Inline editing with AJAX - how do I create multiple editable areas on the same page?	ajax
ASP.net: Can you call ModalPopupExtender from GridView's edit button?	ajax
AJAX/JQUERY/PHP issue...	ajax
ajax requests when navigating in browser	ajax
Preventing ajax-jquery loaded external file from caching in IE	ajax
AJAX Function to populate a field in a form?	ajax
Rails Auth Token and Ajax	ajax
AJAX (prototype/php) getting partial status updates during script execution	ajax
"ajax error - ""permission denied"""	ajax
XML for Ajax PUT or POST request	ajax
Designing Web services for AJAX Consumption	ajax
What is the simplest way to allow a user to drag and drop table rows in order to change their order?	ajax
"Ajax Asynchronous in IE - Error ""The Data Necessary to Complete This Operation is Not Yet Available"""	ajax
Sys.Serialization.JavaScriptSerializer in AJAX autocomplete	ajax
Php include using ajax	ajax
Managing Browser History in Ajax	ajax
online Control Property editor like control property editor in Visual Studio	ajax
override activexobject	ajax
json problem (ajax uploader with zend)	ajax
Refreshing a Table Column via Ajax	ajax
innerHTML size limit	ajax
Sharepoint WebPart with AjaxToolkit's Accordion control	ajax
Jquery can't access original jquery objects from new div on ajx load event	ajax
qTip in ajax content	ajax
How to chain AJAX calls in Rails?  A series of calls to be executed, depending on the result of the first call.	ajax
Client Side Templates in javascript how to bind data	ajax
Ajax with in Ajax. Is this possible	ajax
How to display an AJAX progress bar / message	ajax
web toolkit that does all of this?	ajax
Inserting content into an existing div with AJAX and jQuery	ajax
comparisons of ajax libraries	ajax
how to set time in ajex slider control?	ajax
jQuery AJAX live update on multiple elements on the same page	ajax
AJAX requests Synchronous Vs Asynchronous	ajax
set Request Header in javascript	ajax
cancel or abort ajax call in ie 6,7,8	ajax
Javascript timers & Ajax polling/scheduling	ajax
How can I check my AJAX for browser capable?	ajax
Ajax large screen refresh	ajax
ASP.Net AJAX - Any end-to-end examples of writing a WebControl?	ajax
Ajax Toolkit ReorderList Two components with the same id 'componentid' can't be added to the applicaiton	ajax
How can I dynamically add and remove <fieldsets> using prototype and scriptaculous?	ajax
How can a web application synch a folder of text files on the client's PC?	ajax
Ajax deep linking?	ajax
AJAX, Server Push implementation questions	ajax
How to call Java web service (JAX-WS) from AJAX?	ajax
ajax - getting seperate lines of data	ajax
ajax push and oull	ajax
ajax browser compatability	ajax
ajax :populating 2 drop down boxes via ajax using value of the third one	ajax
paging with ajax and asp.net mvc	ajax
Ajax file upload	ajax
How can I make comments like on stackoverflow?	ajax
Problem with cakePhp and nested ajax form in firefox 3.5	ajax
jQuery RoundedCorners with AJAX	ajax
Using Ajax.Updater to get a javascript file (prototypejs)	ajax
can you asyncronously notify a web browser?	ajax
Is it normal to have a short delay after .innerHTML = xmlhttp.responseText; ?	ajax
'XMLHTTPRequest is Undefined' IE6	ajax
Ajax: wait X seconds before load	ajax
Ajax to make browser Load	ajax
Ajax ReordeList and asp:FileUpload Problem	ajax
Simple AJAX code not being recognized	ajax
what is the best strategy  to retrieve form data? client ajax / server	ajax
STOMP and JSON	ajax
Embedding an image in an AJAX response	ajax
Problem with caching (maybe) when using AJAX and PHP	ajax
File Structure / Architecture for AJAX Site?	ajax
Learning Ajax - where to search for online instruction.	ajax
Ajax / Json How to change run an INSERT/UPDATE into mysql	ajax
Render page initially and update via AJAX using the same template HTML	ajax
Open Ajax Issue	ajax
Ajax: Definition vs Implementation?	ajax
IE7 onSubmit return false in function may fail?	ajax
define variable to hold non-current date in bash	bash
Validating parameters to a bash script	bash
How to assign a heredoc value to a variable in Bash?	bash
Can you prevent a command from going into the bash shell command history?	bash
Bash script what is := for?	bash
split svnversion output in bash	bash
Scripting for bash screen	bash
sort | uniq | xargs grep ... where lines contain spaces	bash
if statement error bash	bash
bash : Make job every x days	bash
"""cp --parents"" in MS-DOS/VBScript"	bash
count number of files generated from split command	bash
command substitution but without breaking output into multiple arguments	bash
In bash, how does one clear the current input?	bash
Bash: easy way to put a configurable load on a system?	bash
How to tell if a sting is not defined in a bash shell script?	bash
Does anyone have experience with clusters running on ClusterVisionOS?	bash
Compress a Mysqldump that is SSH'd to another machine	bash
How to parse POST data in a CGI script with BASH scripting?	bash
Find float in a text file	bash
BASH ^word^replacement^ on all matches?	bash
Bash Scripting and bc	bash
ls Return Values	bash
more efficent shell text manipulation	bash
Using xvkbd to read a barcode. How to disable Enter key?	bash
Can I pass an arbitrary block of commands to a bash function?	bash
Reading multiple lines in bash without spawning a new subshell?	bash
The easiest way to replace white spaces with (underscores) _ in bash	bash
"How to read using ""read"" from file descriptor 3 in bash script?"	bash
How to build a conditional assignment in bash?	bash
bash: filter away consecutive lines from text file	bash
How to properly make path handling robust in a bash program?	bash
Bash loop - tokenize on lines rather than words	bash
Concatenate strings in bash	bash
escaping 'run' command line options in cygwin	bash
bash: $[<arithmetic-expression>] vs. $((<arithmetic-expression>))	bash
Bash: limit the number of concurrent jobs?	bash
Another shell open when at server?	bash
Bash: space in variable value later used as parameter	bash
How to use > in an xargs command?	bash
Bash: ambiguous redirect	bash
How do I use tr to substitute '--' string	bash
What goodies are present in UNIX shells sans BASH?	bash
Susbtitution in sed with spaces	bash
How to change icon/emblem of a directory from bash	bash
How to list running screen sessions ?	bash
Bash combine two arrays	bash
Check if a program exists from a bash script.	bash
Find file launching a process	bash
execute conky with a cron job and bash	bash
Opening named pipes in non-blocking mode in bash	bash
Query in Shell Script	bash
"How do you handle the ""Too many files"" problem when working in Bash?"	bash
Status bar in bash	bash
choosing rows form a file	bash
What are replacement and new practices from sh to Bash?	bash
"can ""nice"" and ""exec"" cooperate in linux?"	bash
How to check if gcc has failed, returned a warning, or succeeded? (in bash)	bash
Is bash scripting still the way to go?	bash
Bash Case menu - dynamic choices	bash
How do I use a pipe in the exec parameter for a find command?	bash
How to get all matches from regex?	bash
is bash getopts function destructive to the command-line options?	bash
How do I use regular expressions in bash scripts?	bash
Switch from file contents to STDIN in piped command? (Linux Shell)	bash
How to search an expression in a file from a bash script?	bash
Little Bash Script: Catch Errors?	bash
Bash, argument list segment	bash
Errors on beginner bash script	bash
How to split a file and keep the first line in each of the pieces?	bash
How does RubyGems modify $PATH	bash
Turn off error messages in a bash script	bash
Timing concurrent processes in bash with 'time'	bash
Bash - Passing arguments by reference	bash
Cmdline Bash Variable Weirdness	bash
replace a particular value in a string of key - values	bash
Why can't I use job control in a bash script?	bash
Moving a directory atomically	bash
How can I use linux to parse out only a section of a variable with different delimiters?	bash
Access X11 display from empty environment (bash)	bash
Correct Bash and shell script variable capitalization	bash
Bash || within if []; block	bash
Wait for bash background jobs in script to be finished	bash
how to make a PHP process auto-restart when dead?	bash
How can I pass a complete argument list in bash while keeping mulitword arguments together?	bash
Add a single Bash command	bash
Horizontal scroll in a bash window	bash
Extract substructure from a text file using bash or python	bash
"Control-r reverse-i-search in bash: how do you ""reset"" the search?"	bash
Functionality in .profile (login script) versus distributing to other scripts.	bash
How to wait in bash for several subprocesses to finish and return exit code !=0 when any subprocess ends with code !=0 ?	bash
Can't read variable that was stored from within a while loop, when out of the while loop.	bash
Bash Script to find the most recently modified file	bash
load the result of an egrep inside a editor (vim/emacs/gedit)	bash
Capturing output of find . -print0 into a bash array	bash
how to base64 encode /dev/random or /dev/urandom?	bash
using find with exec	bash
How do I schedule a process' termination?	bash
capturing standard error into a variable in bash	bash
Use a cat + grep as an included source in bash	bash
modify comfig file using bash scirpt	bash
Printing out names of only directories and not files (BASH)	bash
Synchronize shell script execution	bash
how to automatically ignore files in grep	bash
How do you set a directory to have persistent group permissions?	bash
How To Removing Trailing Whitespace Of All Files Recursively?	bash
Bash scripting, checking for errors, logging	bash
email from bash script	bash
How to sort by line length, then reverse alphabetically	bash
Linux command line: split a string	bash
How to use environment variable inside a quoted string in BASH script	bash
Multi-threaded BASH programming - generalized method?	bash
Bash loop command until file contains n duplicate entries (lines)	bash
Bash. Test for a variable unset, using a function	bash
Linux shell scripting	bash
How to execute a bash command stored as a string with quotes and asterisk	bash
How to get CURL to save to a different directory?	bash
running two bash commands simultaneously on two different computers from one script	bash
Wildcard expansion - searching for one in a set of possibilities	bash
help with selecting rows using awk	bash
Bash syntax question: variable in brackets {} with # comments?	bash
How to add a progress bar to a bash script?	bash
Transpose a file in bash	bash
stderr redirection to stdout	bash
Reducing CPU processing time by using nice?	bash
Need help understanding a bash command	bash
Creating indented text with bash	bash
Why my bash can't execute R script ?	bash
Writing bash script to read, compare, and verify external IP address.  Need help.	bash
How do I check in bash if a process (or one of its children) is actually doing something (CPU/IO)?	bash
how do i make sure my bash script isn't already running?	bash
How do you use Binary conversion in Python/Bash/AWK?	bash
Variable assignment in bash	bash
local variable inside  the loop issue	bash
Timing a Curl Operation in Bash	bash
Using change directory (cd) inside scripts - best practices	bash
chroot + execvp + bash	bash
Shell script - Two Foor loops and changing extension of file	bash
What are your most important console aliases?	bash
Bash - Remove non-word characters from a file but keep newlines?	bash
pushd/popd on ksh?	bash
Mixing regular expression and other conditional expression in a bash if statement	bash
Bash script to create symbolic links to shared libraries	bash
Parse players currently in lobby	bash
Bash script to pack file names	bash
Capturing multiple line output to a bash variable	bash
bash, find files which contain numbers on filename	bash
BAsh Script -- logname validation	bash
Favorite Bash Prompt	bash
How to GZip every file separately	bash
Hi, Any body suggest me how to write formuale in EXCEL for my requirement	excel
Excel: filter table rows by specified column value	excel
Is there a tactical (read 'hack') solution to having the VBA code and Excel sheet as one binary file?	excel
Gridlines in excel through interop	excel
Convert Excel 95 to Excel97+ without automation?	excel
Tool to help write Excel formulas and IF statements?	excel
excel text formula to extract words seperated by semicolon in a field	excel
Excel vba: error hiding calculated field in Pivot tale	excel
Parsing xls with groups	excel
Excel Interop: Range.FormatConditions.Add throws MissingMethodException	excel
excel data same row	excel
excel string comparison is failing when it should not	excel
Merge contents of 2 Excel cells keeping character format intact (using VBA)	excel
Excel Solver not obeying binary constraint	excel
How to pull data and export to excel within an ajax framework.	excel
find formula in excel	excel
Making Excel 2002 use .NET v2.0.50727 runtime	excel
Excel XML Line Feeds in Fields	excel
XL VBA - Passing an array in a user defined function?	excel
Create Excel document from a ContentType in SharePoint	excel
How to reference logo image multiple times in Excel 2007	excel
"What causes ""Invalid advise flags"" run-time error in Excel VBA?"	excel
Excel TreeView multi columns	excel
Moving  MS Excel data to a website via a web service.	excel
excel macro to change unformatted text data to corectly-typed data	excel
Is it possible to call .NET code from Excel 2007?	excel
Upload An Excel File in Classic ASP On Windows 2003 x64 Using Office 2010 Drivers	excel
Combining data from Excel with database	excel
How can I start a specific excel version in com automation?	excel
Microsoft Excel mangles Diacritics in .csv files?	excel
How to obtain the macros defined in an Excel workbook	excel
How can I find the  index of a row for a value in excel  É	excel
How can release excel object with IDisposeable interface	excel
Efficient method to enumerate cells in an Excel workbook using c#	excel
Problem executing excel from C# Application	excel
MS Access Reporting - can it be pretty?	excel
How to get Excel to ignore apostrophe in beginning of cell	excel
How to allow ink in a protected worksheet?	excel
Excel Overtime Calculation	excel
How to auto-size column-width in Excel during text entry	excel
Change value for multiple cells in Excel	excel
MS Access & Excel: Turning a query with dynamic parameters into something useful	excel
Excel VBA: Copy rows from another workbook, but just the function results	excel
Platform or tools for merging & filtering spreadsheet data online?	excel
Bug in HYPERLINK() in Excel 2003 SpreadsheetML implementation	excel
Grabbing text between slashes in Excel	excel
How do I create a multiple tab Excel workbook on a client machine?	excel
Is there a way to use OLE DB Provider for Jet on an unsaved Excel workbook?	excel
Error handling in MS Excel VBA	excel
Read Excel using LINQ	excel
Selecting the max with a condition in excel	excel
Basic excel date and time problem	excel
Exporting excel to xml spreadsheet with blank cells	excel
How do I Refresh Excel whilst Debugging	excel
Excel, multiple if statements	excel
reversing rows in excel formulas	excel
Dynamically changing dropdown in excel.	excel
Microsoft Excel – How to copy cells to a different worksheet on every nth row.	excel
CSV for Excel, Including Both Leading Zeros and Commas	excel
Freezing Row 1 and Column A at the same time	excel
excel workbook isolated storage	excel
Iterating unregistered add-ins (.xla) in Excel 2003	excel
Excel Interop Formatting Issues	excel
How do I programatically interface an Excel spreadsheet?	excel
Access Excel Programmatically	excel
Excel formula to determine cell ID when a series of numbers turns negative	excel
How to make a sub string selection and concatenation in excel ?	excel
Conditional median in MS Excel	excel
VB.NET equivalent of optional Range argument in VBA function	excel
Read password protected excel file using OLEDB in C#	excel
.Net Localization problem	excel
Excel VBA - Stop running program that was started by Shell?	excel
Generating Excel Files with VB6	excel
"Re-Initializing ""ThisWorkbook.Path"""	excel
Problem creating new instance of excel 2007 using VBA	excel
Validation Drop down on a condition	excel
How can I hide Protected Excel AddIn Functions from Appearing in Insert Function Dialogue Box?	excel
Create a custom worksheet function in Excel VBA	excel
Excel VBA to Oracle Algorithm	excel
Excel Comments - Max Length in 2003	excel
MS Excel create virtual column to use in formula	excel
Creating an .exe file from an excel spreadsheet	excel
Pretty Print Excel Formulas?	excel
Nested IF Statements in Excel Formula	excel
Excel formulas giving #VALUE! error when ported to mac	excel
Excel Formula Null Value	excel
Sql server Newbie needs help	excel
"How to parse a ""cut n paste"" from Excel."	excel
how do i convert list in reverse order in excel sheet	excel
Double question in excl strings?	excel
Excel changes date formats	excel
Hyperlink to an Excel Cell	excel
How to get an excerpt of a table in Excel in a different table?	excel
How do I assign a value to a property where the property name is supplied at runtime in VBA?	excel
Call Excel Add-In function from Excel workbook VSTO	excel
deleting named ranges in VSTO	excel
Excel - allow copy/paste but no data entry	excel
What is the great wisdom in defining your own object if I can't do this?	excel
Elegant way to highlight chart data series in Excel	excel
SQL-WHERE TYPE Formulas in Excel	excel
Right click on sheet-tabs disabled in Excel	excel
how do i determine the number of rows in a range in excel using VBA	excel
Excel Pivot	excel
import text file containing line breaks into excel	excel
Excel: the Incredible Shrinking and Expanding Controls	excel
Problems Reading a .xlsx file?	excel
Multiple Cell Background Colors in Excel Spreadsheets	excel
Excel get_Range missing when interop assembly is embedded in .NET 4.0	excel
Unresponsive Cancel Button on VBA Userform	excel
Why does declaring content as a string cause WinHttp not send HTTP content in Excel VBA?	excel
How can I use JavaScript within an Excel macro?	excel
What's the best way to compare two sheets in an Excel workbook	excel
Export Multiple Sheets to Excel Through Browser	excel
String manipulation with Excel - how to remove part of a string if another part is there?	excel
Is there a way to programmatically concatenate excel files?	excel
Exporting .xls to .csv issues	excel
McAfee deletes code from VBA module	excel
How do I save each sheet in an Excel workbook to seperate CSV files with a macro?	excel
What is the best way of generating a xslx file on a web site? Possibly with millions of rows?	excel
Exporting MySQL to Excel	excel
"Excel ""External table is not in the expected format."""	excel
How to Search a value in an Excel from .net application?	excel
How to iterate through all the cells in Excel VBA or VSTO 2005	excel
Need VB to make Excel calculate a sheet or range in realtime and in the background	excel
[VB.NET] Better Way of Getting the Text Value of Cells in an Excel (*.xls) File	excel
To upload an excel file as a clob	excel
how to use a macro to transpose data from rows into columns	excel
making a Macro that exports chosen columns to a new file	excel
How to print faster in Excel VBA?	excel
VB.NET/COM Server code way slower than Excel VBA code	excel
Sql Import wizard imports 1022868890 as 1.02287e+009	excel
Need to embed Excel worksheet in .NET application	excel
Excel hangs when printing the first time from ASP.NET webservice	excel
Embedding Excel files in XSL-FO driven (Pdf)-Document Generation	excel
How do I disable ms query's auto wrapping of column aliases with quotes in excel 2007?	excel
How to keep one variable constant with other one changing with row in excel	excel
"Excel Number Format: What is ""[$-409]"" ?"	excel
Accessing Excel.ComboBox from C#	excel
Execute SQL SP in Excel VBA	excel
Excel: how to create a number in a column according to a text value in other column?	excel
Installing a VBA macro in Excel 2007	excel
Count unique values in Excel	excel
converting an Excel (xls) file to a comma separated (csv) file without the GUI	excel
excel VBA horizontal alignment problems when using NumberFormat codes	excel
Whether to enable a security-protected feature	excel
Keep formatting on an excel cell	excel
Pivot table Values are now screwy	excel
How to circumvent the depth limitation of Excel's IF function?	excel
Is it possible to access Excel file through ADO.NET that does NOT have a Header Row?	excel
VBA - Calling a function which accepts parent object as variable	excel
What supposed to be the signature of my extension-methods	linq
Is my IQueryable syntax correct?	linq
LINQ to SQL in Visual Studio 2005	linq
Linq to Sql: Multiple left outer joins	linq
Linq for java	linq
LINQ to SQL: Concurrency resolution	linq
How to delete a record in linq	linq
Linq SaveChanges question	linq
Linq Error	linq
How do you transfer the execution of a IQueryable object to a IEnumerable ?	linq
Linq OrderBy against specific values	linq
Split a collection into n parts with LINQ?	linq
Sql Query to Linq	linq
Linq Compiled Query using Contains (Like SQLs IN statement)	linq
LINQ Submit Changes not submitting changes	linq
Cross join (pivot) with n-n table containing values	linq
How do I delete a single row in Linq?	linq
Linq to SQL or Linq to DataSet?	linq
Dynamically building LINQ query using OR operator in VB	linq
LINQ- Combine Multiple List<T>  and order by a value (.Net 3.5)	linq
Linq - Row not found or changed	linq
"what is the difference between ObjectQuery and ""var"" ?"	linq
Mapping collections with LINQ	linq
DataContext Refresh doesn't invoke PropertyChanging & PropertyChanged Events	linq
Linq Join Question	linq
Linq - Casting IQueryable to IList returns null - WHY?	linq
Are LinQ Queries above different LinQ providers possible?	linq
LINQ - dynamic WHERE clause?	linq
Avoiding code repetition when using LINQ	linq
join between two tables with linq to datasets	linq
IQueryable<T> with ASP.NET MVC - Can you use this if Model currently not using LINQ?	linq
How would you write an Upsert for LINQ to SQL?	linq
Is there a linq-y way to union collection properties of a collection of objects?	linq
Should repositories implement IQueryable<T>?	linq
Linq expression trees	linq
Is Linq included in .net 2010	linq
The Microsoft.VisualStudio.Data.Interop.IVsDataProviderManager service could not be found.	linq
Best way to update in Linq To SQL	linq
Why does AsQueryable throw a StackOverflowException?	linq
How can I add an extra item in this LINQ query?	linq
Has someone recent and trusted news about Linq to XSD?	linq
LINQ:: Error in getting User	linq
LINQ: Group by month and year within a datetime field	linq
Vexing linq to sql predicate building in a for loop	linq
Find or Create Element in LINQ-to-XML	linq
LINQ table enumeration with column enumeration	linq
calling a SP which returns a long select return using LINQ	linq
Linq query built in foreach loop always takes parameter value from last iteration	linq
Linq Multiple Grouping	linq
How do I create a linq query that gets everything but a specific value	linq
Are Update/Delete/Insert on the Linq Roadmap?	linq
Linq expression for surrounding numbers in an array	linq
to do a substring using LINQ on a string, do I have to correct syntax?	linq
LINQ to XML - How to implement a simple XLink lookup - finding nodes anywhere	linq
Linq, repository pattern and database abstraction problem	linq
Nested Group by in LINQ	linq
linq to xml - get rid of blank xmlns	linq
Remove Single Quotes From All Cells in a DataTable - Creating New Table - Using LINQ in Vb.Net	linq
Using LINQ to query flat text files with fixed-length records?	linq
LINQ many to many Left Join Grouping	linq
Linq 2 SQL: Setting ObjectTrackingEnabled to false breaks lazy loading of child entities?	linq
Adding a custom member to a mapped type	linq
Using Linq Expressions to decouple client side from DAL (which is server side)	linq
List of unique strings in database table using Linq?	linq
Advanced linq book?	linq
How do you declare a by-reference parameter variable for use in a Linq query?	linq
Linq PredicateBuilder - Multiple ORs - Newbie Q	linq
Linq to SQL question - specifying columns then modifying column	linq
Why is the Intellisense for properties and methods of instantiated datacontext not showing?	linq
Linq2Entities / Linq2Sql - Comprehensive search...	linq
Linq to SQL vs Entity Framework, Microsoft support for	linq
Optimizing a LINQ query.	linq
LINQ: what is the type of a result?	linq
Linq and heavy blobs	linq
LINQ datacontext lifetime managment for web application	linq
Linq to Sql - return selected specified columns	linq
Linq to filter directories	linq
Can I start with a string and instantiate an object of that string?	linq
IQueryable  Where Extention Method with  Or's	linq
multiple orderby in this linq code	linq
C# LINQ: Sequence Contains No Elements Error (but I want to check for null!!!)	linq
LINQ: IEnumerable<KeyValuePair<SomeType, IEnumerable<OtherType>>>  selection	linq
How to succesfully join two in-memory linq collections?	linq
How to get unique First Letter of names and count of names starting with that letter from SQL Server using LINQ?	linq
Linq | Date | Subtraction with matching issue	linq
lamda extension to combine lists	linq
"""Hiding"" linq classes inside a namespace?"	linq
"Can I perform an ""or"" operation in LINQ to objects?"	linq
LinqToSql - Multiple subqueries creates many roundtrips	linq
How to Count Duplicates in List and Sort by amount of Duplicates with LINQ	linq
How save XPathExpression result to separate XML with ancestor structure?	linq
C# Ranking of objects, multiple criteria	linq
How to convert a list of ints to a string array in Linq?	linq
LINQ -Single operator	linq
Does this linq query runs on every iteration of the for-each loop?	linq
Adding related data with multiple LINQ to SQL DataContexts	linq
Read Anonymous Type from DataItem	linq
What is LINQ to events a.k.a RX Framework?	linq
TransactionScope, linq and strange transaction manager issue (HRESULT: 0x8004D024)	linq
How to get a custom object out of a generic List with LINQ?	linq
how to use foreach in linq	linq
Is there a better way to code this LINQ fragment?	linq
What is the quickest way to query a database with LINQ?	linq
How mainstream is LINQ?	linq
LINQ retreive values from a table that of which fields(of a cetain column) are not equal of another table	linq
Combining resultset in C# using Linq	linq
What is the most concise way to find the existence of a node using LINQ to XML?	linq
Linq - How to aggregate the results of another query	linq
LINQ: find all checked checkboxes in a GridView	linq
What is the best way to sort using a GridView and LiNQ?	linq
bug in linq Contains statement - is there a fix or workaround?	linq
databind a sharepoint list to a dropdown using linq	linq
DeleteOnNull (Association attribute) for Linq to SQL in custom class?	linq
Extracting generic Linq queries	linq
table alias in linq edmx	linq
LINQ to SQL	linq
LINQ to resx?	linq
Sum of items in a collection	linq
Linq Dilemma	linq
Switching to LINQ	linq
What's wrong with this linq query??	linq
Another LINQ Pivot Problem - Convert SQL Script to LINQ	linq
Can I define Default Sort order in LinQ	linq
Bulk-deleting via LINQ	linq
Conditional Linq Queries	linq
LINQ: Distinct values	linq
LINQ + lightweight database, which db to choose?	linq
Using Linq to Sql, how can I get a particular result from a query?	linq
refactoring LINQ IQueryable expression to remove duplicated portions of queries	linq
Select a Dictionary<T1, T2> with LINQ	linq
Select Rows from a DataSet using LINQ, where the list of RowsID's are in a List<T>	linq
How do dynamically set group by properties and aggregates in a LINQ query?	linq
Sorting a list using Lambda/Linq to objects	linq
Querying against LINQ to SQL relationships	linq
LINQ across multiple databases	linq
Temporary tables in Linq -- Anyone see a problem with this?	linq
LINQ grouping/subquery to fill a hierarchy data strcuture	linq
Linq - what locale/collation it uses to compare objects?	linq
Linq: In what situation do you use linq?	linq
EntitySet<IEnumerable<T>> to IEnumerable<T>	linq
LINQ Anonymous Types + MVC Views Help	linq
how do i get the min from a linq to dataset query	linq
Linq to objects nested group-by	linq
Strongly typed dynamic Linq sorting	linq
IntelliSenss for XElements object with XML schema	linq
LINQ - how to convert query syntax to method syntax	linq
LINQ to SQL Left Outer Join	linq
LINQ Except operator and object equality	linq
LINQ Conflict Detection: Setting UpdateCheck attribute	linq
Should I consider LINQ to Entities?	linq
How do I code in Qt under the LPGL and maintain proprietary code?	qt
Qt must-read	qt
Thread id in QT	qt
Hidden features of Qt.	qt
Qt LGPL license exception?	qt
Using Qt Creator with Git version control	qt
Focusing on a tabified QDockWidget in PyQt	qt
Using Win32 API in Qt OSE project	qt
Qt Application fails spectacularly	qt
How to connect a slot to signal QProcess::started() ? QT	qt
How to change Qt applications's dock icon at run-time in MacOS?	qt
Scrolling different Widgets at the same time	qt
Python Qt: Qprinter not defined	qt
How do I add a header with data to a QTableWidget in Qt?	qt
Is it possible to see definition of Q_SIGNALS, Q_SLOT, SLOT(), SIGNAL() macros? (Qt)	qt
Question about Qt slots and multiple calls	qt
How to show Tooltips in Qt	qt
Updating a QProgressDialog with a QFuture	qt
Search Box in QToolbar	qt
Qt QFileDialog input field - tab complete like shell	qt
Qt and context menu	qt
Should I remove QDebug header for release?	qt
QThread Not Starting	qt
QT UI for existing C++ project	qt
Blinking background cell in a model	qt
How can a Qt client talk to a Spring server application?	qt
How to update QCompeter's model dynamically	qt
Is it possible to have a QWidget as a child to a QObject?	qt
QSlider focus issue (Mac Leopard) with QApplication::focusChanged(QWidget*,QWidget*)	qt
Get visible rectangle of QGraphicsView?	qt
How do I run XPath queries in QT?	qt
On QT widgets like DoubleSpinBox or ComboBox, how do i have custom right click menu	qt
How to acquire an event only at defined times?	qt
Is there any special category for external files in project file of Qt Creator?	qt
Emitting signals from other threads	qt
Nonclosing close button in Windows Mobile ( developed with Qt)	qt
Compiling Qt using MSVC 2005 and dealing with SxS Windows	qt
Linking with a debug/release lib with qmake/Qt Creator	qt
Qt, Mouse skipping, not updating every pixel, mouseMoveEvent()	qt
Qt: QList of QButtonGroup	qt
Insert Images to list	qt
Can I make QCompleter complete inline and show a popup.	qt
QT Model/View programming with complicated data structures	qt
QObject::connect issues with QAbstractItemModel	qt
Slow selection in QTreeView, why?	qt
Why does Qt include empty class definitions of existing classes in the header files?	qt
Qt Animation: Appearing & Disappearing Objects	qt
How to find global position of text cursor?	qt
Qt Show/Hide widget animation	qt
How do I watch a serial port with QSocketNotifier (linux)?	qt
Qt, Getting the text when QPainter::drawText() is called	qt
Change background of QTabBar tabs using stylesheets	qt
Cocoa Textured Window in QT	qt
QT how to use std::string in a QLineEdit	qt
Change tab stop size in rendered HTML using Qt's QLabel class	qt
rbuic on windows	qt
Styling QPushButton with CSS?	qt
For QDoubleSpinBox, can I give an range 0.0<min<max<1.0. If yes how do I get the step buttons to work with it	qt
How to disable the up/down buttons within the QDoubleSpinBox	qt
Qt: transparent QRubberBand?	qt
Corrupted Qt Widgets on Windows Mobile	qt
Fewer connections in a Qt calculator	qt
Does anyone commit Qt to their own source control?	qt
Qt widget update later but when?	qt
Open External Browser from QWebView	qt
how can I have more than a UI for a QMainWindow?	qt
QTMovie Notification	qt
*** glibc detected ***  double free or corruption (fasttop):	qt
Why does my QT4.5 app open a console window under Windows?	qt
Dynamically manipulate Qt GUI	qt
Displaying translucent / irregular-shaped windows with Qt	qt
How to tell QWebPage not to load images?	qt
Qt, VS2005, Qwt - Can't use Q_OBJECT in class derived from Qwt widgets	qt
QT in a professional setting	qt
bring the application from in focus, by clicking the icon of corresponding application	qt
I'm looking to use Visual Studio to write and compile using the open source version of Qt4.	qt
QTextEditor returns quotes(	qt
How to intercept ALL signals emitted by a given event in QT?	qt
Show dialog/frame fullscreen on a second sceen sing QT/c++	qt
Qt wrapper for C libraries	qt
Is there an analogue to Qt's QCanvas in Windows Forms?	qt
Building the Multimedia Module of Qt Mobilty with QML Extensions	qt
QT question about a QList<QStingList>	qt
IE window in QT	qt
Add QRadioButtons on runtime.	qt
Displaying multiple icons in a single cell of a QTableView	qt
QThread issues. Crash after 2058 runs.	qt
QAbstractSocket::UnknownSocketError	qt
is there a way to  combine Qt-Creator + Boost Library?	qt
How to fire user-like event in QWebElement	qt
Can I use a QTimer to periodically refresh a form while still letting user edit some of the fields?	qt
How to change string into QString?	qt
QByteArray to integer	qt
Deleting 'QNetworkReply *' returned by QNetworkAccessManager::post	qt
Is there a workaround for Qt 4.4 visual artefacts on Mac OS X 10.6 (snow leopard)	qt
Qt QIcon to load SVG files?	qt
QAbstractTableModel inheritance vtable problem	qt
Controlling the order of QObject children (possible workaround?)	qt
QProcess::setStandardOutputFile only creates 0kb File	qt
How to make binary distribution of Qt application for Linux	qt
How do I set the execuable attributes with qmake for a c++ project?	qt
What is the minimum amount of tweaking needed to get QClipboard::setText() to work under X11?	qt
Qt Equivalent of NSTokenField	qt
Qt + VTK + Cmake	qt
QDialog doesn't accept text input if modal	qt
QNetworkAccessManager/QNetworkReply with custom QTcpSocket?	qt
Qt SOAP install	qt
Set a QComboBox or QSpinBox to a value not allowed	qt
Qt create game host	qt
Include problems when using CMake with Gnu on Qt project	qt
Use Preferences menu item.	qt
How to use linux fonts in windows QT?	qt
"Building optimized Qt4 - ""./configure"" flags and their meanings"	qt
QT, making UI that shrinks and expands	qt
Why library name gets an additional 0 is its name?	qt
QT: custom widget in QScrollArea	qt
Qt Linking Error.	qt
Is QT classified as a c++ library? If not a library, how would you classify QT?	qt
in Qt, How do I make a window be the current window?	qt
Any idea for running Qt signals/slots over network?	qt
Qt dialog with no window icon	qt
Qt: Expand ~ to home-directory	qt
Penalty of using QGraphicsObject vs QGraphicsItem?	qt
How can I get rid of the resize-handle in a QDialog?	qt
QT GUI internals - widget painting?	qt
qt cannot open input file 'c:\Qt\qt\lib\qtmaind.lib'	qt
Qt context menu breaking selection in QTreeView	qt
Is there a way to package a dynamic library in the application binary?	qt
which platform do I need to install for qt for apps running on windows and linux	qt
Qt::How to prevent an icon being highlighted?	qt
What exactly changed when QStandardItemModel itemChanged is signaled	qt
C framework like Qt ?	qt
Raise and lower QTreeWidgetItem in a QTreeWidget?	qt
obtaining text from a QListView	qt
In Qt4, how to check if paintEvent is triggered by a resize?	qt
Way to do radio buttons in Qt 4.4.3 menus	qt
How to remove maximize button in Mac OS X tool window in Qt	qt
QPixmap from QBitmap	qt
QComboBox with single value: Select this value	qt
How can I simulate user interaction (key press event) in QT?	qt
qt add path for 3rd party header and libraries	qt
QT 4.6 release date	qt
How do I fix my application from leaking when using Qt 4.5?	qt
Qt Map Signals Based On Parameter Value	qt
Qt stylesheets: QHeaderView draws header text in bold when view data is selected	qt
Qt: New student to Qt questions	qt
Simple inter-proccess communication in Qt4	qt
Why am I unable to use QT with Visual Studio 2008?	qt
How can I add a user editable checkbox in QTableView using only QStandardItemModel	qt
exception Handling in Qt Script with C++	qt
How dangerous is this sql query?	drupal
Theming the default search results page in Drupal	drupal
Custom products in Drupal or OSCommerce?	drupal
Drupal CCK field not visible to anonymous users	drupal
importing content into drupal.	drupal
Give away signs that a site is Drupal?	drupal
$content variable in node.tpl.php (Drupal 5)	drupal
How does AOP work in Drupal?	drupal
drupal rules adding field data to referenced node without replacing existing data	drupal
Please Check For Idiocy: Customizing Taxonomy Term Page in Drupal	drupal
drupal: load view template on module activation	drupal
"""Take this test to find out if you are..."" type of module in Drupal?"	drupal
What is the correct procedure to install a Drupal security patch?	drupal
How to open a flash SWF in ThickBox in Drupal on page load, and close it after x seconds	drupal
drupal Generate a PDF catalog from a bunch of nodes	drupal
Time field in Drupal forms?	drupal
Drupal: How to implement a SECOND admin with fewer rights than the normal and own theme?	drupal
How do you migrate CCK fields between environments in Drupal?	drupal
"Drupal for users creating ""sub""-users?"	drupal
How to create new theme in drupal 7	drupal
learning drupal fast track: how to create a stackoverflow clone?	drupal
password recovery for drupal	drupal
Drupal: Display variables in an embedded node	drupal
using Drupal for 1 page of xhtml-css website.	drupal
Understanding Drupal core?	drupal
Drupal theme() problem	drupal
City selection on UberCart checkout menu?	drupal
Is the Zen theme for Drupal enterprise ready?	drupal
cck remote file (image) field - I want to keep the cached copy of the image when the node is deleted	drupal
Drupal Content Type (Restaurant) Design	drupal
Drupal, Translating menu PATHS	drupal
What's the advantage of using drupal's module_load_include vs. just including a file?	drupal
Unable to enable jquery UI module in drupal??	drupal
Multiple sections in Content Block for Drupal	drupal
How does Drupal provide an edit/review/publish model?	drupal
Drupal Nodes shows 404 when it exists	drupal
Drupal vs Wordpress performance comparassion	drupal
Drupal Views 2 path	drupal
Possible to save a node using a multi-step form?	drupal
Drupal 6, how to identify active menu item by url parameters (full link), ?q=page1&filter=10	drupal
Running hook_cron with administrator privileges in Drupal 6	drupal
What makes Drupal better/different from Joomla	drupal
Drupal: include small form in page.tpl.php	drupal
query limit issue with php and mysql (drupal 6)	drupal
Drupal: Associating grouping more than one CCK field.	drupal
My under development local drupal site become very slow, how to solve?	drupal
Customize the way CCK Node Reference fields are displayed in Drupal	drupal
Drupal: Creating a simple blog?	drupal
Drupal Login using  parameters for login and password in url	drupal
Does the order of cases matter in PHP switch statements?	drupal
Validating Registration Data with an External Identity Repository in Drupal	drupal
Drupal: How can one hook exit in a custom module be called in every page request?	drupal
Drupal 6: How to quickly theme a view ?	drupal
Drupal: How do I modify my menu items' classnames?	drupal
Custom File Filter Upload	drupal
Drupal: Staying Organized with Module Changes	drupal
Drupal FileField remove file from node but leave on Server	drupal
Drupal: How to format email message using node invite module?	drupal
Drupal 6 Hide Revision Information	drupal
Is there option to have powerfull URL and Aliases in Drupal, not the poor one that I've found?	drupal
Drupal: View with exposed Taxonomy filter.. 3 questions	drupal
Update {node_counter} table programatically in drupal	drupal
Use SQL to Filter Drupal Views	drupal
Changing the Admin Theme in Drupal 6 Directly in Database	drupal
Drupal vs ExpressionEngine for any kind of project from simple commercial site to complex ecommerce portals.	drupal
How can I open a Drupal 6 submenu programmatically?	drupal
drupal form override theme function	drupal
Sorting grouped nodes by taxonomy term	drupal
How to implement seasonal logos in Drupal?	drupal
Longer Form Fields in Drupal	drupal
Intelligent Keyword Searching	drupal
Drupal Custom Login by Role	drupal
Drupal — Fatal error: Class 'Memcache' not found	drupal
What is a user category exactly?	drupal
Views Exposed Filters as list of links instead of select	drupal
"Preventing form_token from rendering in ""GET"" forms"	drupal
Embedding inline advertisement in nodes in Drupal 6.x ?	drupal
drupal how to see the query when the node is created or any contetn type is created	drupal
I want to create blog posts to drupal by sending messages through Outlook. Ideas??	drupal
Handling file uploads in Drupal	drupal
Drupal: using a view on a Page/Panel, prevent default listing of content	drupal
How to show inactive task tabs in Drupal	drupal
Drupal node_save no longer returns $nid, so how do I get it?	drupal
how to build Drupal 6 user form that display results on page ?	drupal
drupal what if we have designed a content type with existing fields	drupal
How to time-delay email deliveries?	drupal
Drupal Coding Standards for Commercial Use?	drupal
Why does drupal_get_title() return empty on a Views page?	drupal
Content Top Drupal Theme	drupal
file path from sql query in drupal	drupal
Set values for an exposed field in a block (in Drupal)?	drupal
Mixing Static Strings with Views Arguments	drupal
Drupal: Is it possible to insert php variables from one node into another node?	drupal
Drupal How to get a view to display as columns rather than rows	drupal
How to additionaly filter list of published nodes in Drupal 6	drupal
Panel Template Reuse in Drupal	drupal
Using .inc files when theming.	drupal
Drupal: No themes are rendering	drupal
Drupal Displaying the Vote up down widget 2.x	drupal
Detect which other modules are enabled in a new Drupal module	drupal
Saving nodes with a filefield	drupal
drupal: adding simple links to a block	drupal
Drupal Views: output item fields grouped by field instead of item?	drupal
Drupal View with Taxonomy Argument Display	drupal
Month navigation sidebar in blog section?	drupal
Customize the way a Drupal Menu looks like from my Theme	drupal
Forcefully trigger a rule in Drupal?	drupal
Drupal: How to know the type of a tid (term id)?	drupal
How to associate node with products in Drupal/Ubercart	drupal
can drupal support wordpress themes for blog in php?	drupal
Drupal-Salesforce with NuSOAP	drupal
drupal menu and jquery menu	drupal
How to Deploy a Drupla Site on a Web Farm ?	drupal
How do I rank nodes based on user-rating, number of comments etc. in Drupal 6	drupal
Modifying Webform module	drupal
Drupal: Can I avoid forwarding after content is created / saved ?	drupal
Underscore before theme name	drupal
What version of TinyMCE will work in Drupal 5 with google chrome?	drupal
Custom way to display Views in Drupal	drupal
How do I send automated e-mails from Drupal using Messaging and Notifications?	drupal
Possible pitfalls on a multilingual Drupal site?	drupal
How to use AJAX in DRUPAL	drupal
How to serch by categories uisng trip_search	drupal
Making a drupal database call using ajax	drupal
Passing Multiple Arguments from Panels in Views ( Drupal)	drupal
Drupal: Duplicate search block?	drupal
Creating custom CCK Field Types in Drupal	drupal
"DRUPAL: my back-end edit node page jumps up when I click ""save"""	drupal
drupal: getting nodeautoterm node ids from taxonomy ids	drupal
Drupal form_submit and default_value	drupal
Simple Drupal sub-themeing...what am I doing wrong...?	drupal
Drupal / Rules: flagging multiple terms on user save	drupal
Web application in drupal?	drupal
Changing Drupal notifications e-mail address	drupal
Limiting the total number of certain types of nodes a user may create in Drupal by role?	drupal
How can you implement jQuery code in Drupal pages (for non-coders)	drupal
drupal taxonomy term path to return alias	drupal
Batch node operations in Drupal 5	drupal
Need help choosing a framework for bilingual site	drupal
jQuery $.get() not working in Drupal 6	drupal
Drupal wizard form: Validation and previous button	drupal
Drupal - Including more than one user_profile_form on a page?	drupal
"Removing ""user-profile.tpl.php"" but it doesn't revert to default view"	drupal
How can I keep data in sync during deployment?	drupal
D6: a homepage with only blocks?	drupal
How to enable node-type based custom menu in drupal?	drupal
Creating nodes porgramatically in Drupal 6	drupal
Drupal view rows output	drupal
Moving a non-core theme from /themes to /sites/default/themes safely in Drupal 6.14	drupal
How to find which menu a node belongs to in drupal	drupal
PHP's preg-match_all causing Apache Segfault	apache
Trying to put an exception to RewriteRule in .htaccess	apache
Parse file upload directly without writing to the file system	apache
apache route to program download	apache
Apache Timeout directive not working?	apache
How to encode url in apache rewrite?	apache
RewriteRule checking file in rewriten file path exists.	apache
Why do my hot-deployed files disappear sometimes? (I think Apache has something to do with it)	apache
Apache BeanUtils.copyProperties is spilling too much log	apache
Is there a way to encode a URL in velocity template	apache
Apache is listening on a different port, but how do I get it so I don't have to type in the port number?	apache
Differences between stock Apache on OS X 10.5 Leopard and OS X 10.5 Leopard Server?	apache
Apache mod-proxy load balancer maintenance	apache
Apache2: Environment variables for user http	apache
How to always remove WWW from a url with mod_rewrite?	apache
Apache logs -- what is difference between %a and %h?	apache
apache-webserver-website publishing	apache
url_rewrite /#/something/here to /something/here	apache
How to benchmark apache with delays?	apache
User getting default Apache page instead of website - Safari/FF?	apache
Apache Rewrite Override Mime and Proxy Request?	apache
How do I tell Apache which PHP to use?	apache
Configuring mod_rewrite and mod_jk for Apache 2.2 and JBoss 4.2.3	apache
Undefined symbols compiling apache module mod_transform on Mac OS X	apache
Apache Tomcat 6 Problem Not Found(404)	apache
Using .htaccess and mod_rewrite in a directory (not root)	apache
[Apache] RewriteRule removing trailing dot.	apache
Location of web app on my server and Apache.	apache
CodeIgniter Backend Frontend .htaccess router	apache
Apache lags when responding to gzipped requests	apache
Do you have to restart apache to make re-write rules in the .htaccess take effect?	apache
Getting basic information when taking over administration of a server.	apache
Setting a header in apache	apache
Configure Apache to use Python just like CGI PHP	apache
301 Redirect with query string and domain name in Apache	apache
How to tell Apache, in reverse proxy mode, to intercept or trap 302 responses from backend server and redirect internally without sending 302 response back to client?	apache
Avoiding sub-directory request rewrites with Apache mod_rewrite	apache
switch mod rewritten URL	apache
Cleaning up nested mod_rewrite statements	apache
htaccess mod_deflate does not work on shared server	apache
Where does the tomcat axis file server-config.wsdd come from?	apache
Absolute file paths in mod_rewrite - allowed?	apache
Redirecting Apache by Geo/Country IP	apache
Restrict certain URLs to a single thread	apache
Why would the browser cache assets (images, js, etc.) while GETting but re-request everything after a POST + 302 redirect?	apache
Is there a way to return 404 Not Found for prohibited directory listings in Apache?	apache
How to keep URL display unchanged after redirecting root folder to sub folder	apache
.htaccess mod-rewrite how to	apache
Create subdomain upon user registration	apache
How do I stop search engines indexing a maintenance page	apache
Apache Webservers	apache
How to convert Apache .htaccess files into Lighttpd rules?	apache
stop apache injecting it's own 404 not found page to the custom 404 error page	apache
Apache htaccess on Win2k is not being processed	apache
Apache Redirect 301 fails when using GET parameters, such as ?blah=...	apache
"AJAX-safe way to post-process / ""wrap"" arbitrary web pages?"	apache
Internal Server Error	apache
Can Apache BalancerMember be configured to use unix domain sockets?	apache
In apache, if i go to https://mysite.com, the page itself is over https, but all images/links are http://. Is there way to auto rewrite the html so its all https://?	apache
Apache mod_rewrite - rewriting from subdomain to main domain	apache
Configuring subdomains on an Apache Server	apache
I want to host my own home web server. I installed Apache already but I can't log in other computers	apache
.htaccess and seo-friendly urls	apache
Apache RewriteRule with RewriteMap	apache
Link to download apache http server  source for windows	apache
Problem in migrating to LAMP from XAMPP.. Memory limit error	apache
How to clear PHP $_SESSION by apache?	apache
Using j2ep on an apache-tomcat cluster - design help	apache
PHPIniDir broken under windows 7?	apache
Add header in apache	apache
Does Mongrel do IPv6 well?	apache
Mask redirect to temporary domain with mod_rewrite	apache
"apache: cgi links lead to a ""you have chosen to open foo.cgi"", although scriptalias is set"	apache
Is storing config variables in an XML file on a PHP site under the site root too risky?	apache
How do you use mod_rewrite to move a site down a sub directory?	apache
How can I get my website to display a .c file instead of trying to make the user download it?	apache
Apache url rewrite problem	apache
apache xampp gzip	apache
Apache base URL for subdirectory?	apache
How to tell Apache ignore/block 404 error and redirect to hander page?	apache
Same Port, but different DocumentRoots	apache
Apache Tiles 2.1.4 with CSS	apache
Output of sub-processes in DOS batch script not visible in Apache	apache
Apache file caching	apache
Configuring Apache Web Server with Tomcat	apache
Redirect to Apache default 404 page with mod_rewrite?	apache
Relative / Root paths on apache / cpanel / php shared hosting	apache
XAMPP and WAMP in the LAMP, whats the best ?	apache
SSI escape HTML output	apache
Use Apache behind Proxy	apache
"when should I use ""apache:apache"" or ""nobody:nobody"" on my web server files?"	apache
Apacahe Name Virtual Host with SSL	apache
web page finish loading before all images is completed	apache
Rewriting query string using mod_rewrite	apache
Redirect 404 to another domain with apache?	apache
Apache mod_rewrite	apache
Rewrite Url with apache2	apache
Apache mod rewrite simple redirect	apache
UTF-8 URI explodes Apache & mod_rewrite	apache
Apache Tomcat server on linux	apache
htaccess rewrite not working for all rules	apache
Apache returns truncated image (cross posted on serverfault.com)	apache
Subdomain read domain session	apache
mod_rewrite loops even with L flag	apache
Long-lived connections (asynchronous server push) with Apache/PHP/Javascript?	apache
.htaccess rewrite to default language folder?	apache
What setting might be causing an AMP server to only allow 1 request at a time per browser?	apache
(Apache) Possible to match UTF8 characters in rewrite rules?	apache
Encoding of the AuthzSVNAccessFile	apache
Apache, PHP and MySQL portable?	apache
Query about Apache (httpd) dumpio log entry for the Request body which is coming NULL on Tomcat side	apache
Warning about bad shutdown preventing apache from running?	apache
User authentication on Resin webserver	apache
Moveable type images not displayed	apache
Apache <Files> with Require to exempt certain Files	apache
Is mod_rewrite a valid option for caching dynamic pages with Apache?	apache
Can you configure mod_proxy as a reverse proxy cache?	apache
apache on windows virtual directory config help	apache
Setting error log filename in apache to include current date	apache
Apache and the c10k.	apache
IP Blocking URLs on Apache	apache
Apache Ant command line arguments without double quotes - is it possible?	apache
increasing ServerLimit & MaxClients on Apache	apache
can abybody explain the structure of apache server.......	apache
PHP using too much memory	apache
Why is Apache seg faulting?	apache
Apache .htaccess hotlinking redirect	apache
Apache: Multiple log files?	apache
ZendFrameworks not working nice with RewriteRule	apache
Is there a way to make git remember the password for WebDAV remotes?	apache
Apache capacity planning tool?	apache
Detecting https requests in php	apache
Apache .htaccess rewrite question	apache
configure apache 6 with mysql	apache
Can I block search crawlers for every site on an Apache web server?	apache
Acessing other webapps while one is in document root	apache
Apache reverse proxy set up secure certificate	apache
Disabling serving PHP files from a folder in .htaccess	apache
Apache+Tomcat6+Struts2 redirect problem	apache
URL Segment Support macosx 10.6	apache
Can I re-write my URLs like this and is it a good idea?	apache
Unexpected Connection Reset: A PHP or an Apache issue?	apache
How to run the equivilant of PHP and MySQL on portable media (eg CD, USB and/or iPhone)	apache
With Apache/mod_wsgi how can I redirect to ssl and require Auth?	apache
Execute shell command in PHP on the desktop of another logged in user	apache
Suppressing / controlling logging in org.apache.xmlrpc.XmlRpcClient ?	apache
Apache HttpClient making multipart form post	apache
Apache/Tomcat site nesting	apache
apache configuration - what am I missing here?	apache
SVN (mod_dav) 403 FORBIDDEN OPTION request	apache
Update all WCF Service References in one click (two clicks would be OK too!)	visual-studio
How to make clipboard ring appear in VS2008 toolbox?	visual-studio
In Visual Studio (2008), can I start up a website debug session as the web root?	visual-studio
Why doesn't intellisense show the appropriate methods according to what I am passing in?	visual-studio
Framework goto definition shows comments, are these generated from xml comments?	visual-studio
Macro to wrap selected with tags in Visual Studio	visual-studio
How to configure Visual Studio not to give UAC prompt on each run?	visual-studio
Eclipse's Crtl+click in Visual Stdio?	visual-studio
What's the best way to create a drop-down list in a Windows application using Visual Basic?	visual-studio
Is there a Visual Studio shortcut for replacing the beginning and ending tag name in XAML/XML/HTML at once?	visual-studio
Visual Studio: How to reference assemblies in Visual Studio?	visual-studio
Creating registerable Visual Studio packages	visual-studio
Team Foundation Server (TFS) File Difference viewer - how to split horizontally	visual-studio
Why Visual Studio doesn't create a public class by default?	visual-studio
.net solution subversion best practices?	visual-studio
Way to see assigned visual studio shortcuts with given prefix	visual-studio
Eclipse's tab double click on Visual Studio?	visual-studio
Visual Studio 2005 crashes on start-up	visual-studio
Visual Studio Refactoring: Remove Structured IF/End If	visual-studio
"What does the option ""convert to web application"" do if I select it in visual studio?"	visual-studio
Is it true, visual studio can't handle fonts installed after it was ?	visual-studio
How do you clear your MRU list in Visual Studio?	visual-studio
How to run just one ASP.NET Development Server in Visual Studio 2008?	visual-studio
mspdbsrv.exe living forever?	visual-studio
What are your most-recommended Visual Studio perferences?	visual-studio
SAXON.NET XSLT 2.0 Processor	visual-studio
Visual studio formatting options	visual-studio
Why can't Visual Studio run on more than one core?  CPU at 25%	visual-studio
"""Cannot change DataType of a column once it has data"" error in Visual Studio 2005 DataSet Designer"	visual-studio
Create SQL Database and add to project using Visual Studio	visual-studio
How to exclude files from Visual Studio compile?	visual-studio
Remove VSMacros80 directory	visual-studio
How will adding DataSources to DatdGrids in my development version of an ASP.NET web application affect deployment?	visual-studio
Keep indentation of wrapped lines in Visual Studio 2008	visual-studio
Office XP Shared Addin VS 2008	visual-studio
re writting methods with in a project	visual-studio
Connect Visual Studio 2008 to Virtual PC 2007	visual-studio
"Can I create ""Solution"" level items in a Visual Studio Project Template?"	visual-studio
In Visual Studio, when would I want to use the Test View?	visual-studio
"Visual Studio "">of"" command causes solution explorer to go wacky"	visual-studio
How Can I add additional functions to Visual Studio's Server Explorer?	visual-studio
How do you deal with multiple open files of the same name in VisualStudio?	visual-studio
Getting started with Visual Studio Designer	visual-studio
What do you use to develop for PowerShell?	visual-studio
Is there a Windows equivalent of EDQUOT?	visual-studio
x86 Remote Debugger Service on x64	visual-studio
Debug/Release diffrence	visual-studio
Is there any way to avoid installing Microsoft Visual Studio 2008 Team System Database Edition to be able to build DBPro projects on a centralized build server?	visual-studio
Vertical line limiter in VS 2008?	visual-studio
Tool to automatically reformat whole C# source tree in VS2008?	visual-studio
How to make a visual studio add-in that cannot be unloaded?	visual-studio
Save all files in Visual Studio project as UTF-8	visual-studio
Is it possible to coax Visual Studio 2008 into using italics for comments?	visual-studio
Scripting the Visual Studio IDE	visual-studio
In Visual Studio (2008) is there a way to have a custom dependent file on another custom file?	visual-studio
Does visual studio is only used for programing ?	visual-studio
Visual Studio 2008 SP1 and Visual SourceSafe 2005	visual-studio
Custom color settings in VS.NET editor for current line when in debug mode	visual-studio
Problem with const vs #define in Visual Studio	visual-studio
Visual Studio Find and Replace Variables	visual-studio
What is the most common feature that demands the use of Visual Studio Professional over Standard?	visual-studio
MSVCR90.DLL was not found.	visual-studio
Visual Studio MSTest run failing to even start	visual-studio
Can I generate values for a custom parameter such as a timstamp for a Visual Studio Item Template?	visual-studio
What Code Snippet Editor Do You Use?	visual-studio
"Visual Studio Addin Development - How to resolve the ""The process cannot access the file"" problem after exiting visual studio?"	visual-studio
Visual Studio - How to remove a reference in Release mode	visual-studio
What is your favorite Visual Studio add-in/setting.	visual-studio
"Visual Studio Hosting Process and ""The operation could not be completed"""	visual-studio
Please explain what an outlook add-in is	visual-studio
Code template's indentation is buggy for code behind files in VS2005?	visual-studio
Visual Studio Add-in not going away	visual-studio
Visual Studio Context Menu Shortcut	visual-studio
Is there a tool for emailing Shelveset's and History items from within Visual Studio Team System?	visual-studio
Embedding non-edit widgets in a DataGridView	visual-studio
Iterate enumerable object while debugging in Visual Studio	visual-studio
"Why would Visual Studio/CLR produce a ""bad"" executable?"	visual-studio
Visual Studio and the build for anycpu option	visual-studio
In Visual Studio can i plot my variable in breakpoint ?	visual-studio
How to change the default browser to debug with in VS2008?	visual-studio
Visual Studio shortcut for showing dropdown of availble Enum values for function argument	visual-studio
What's the name of Visual Studio Import UI Widget (picture inside)	visual-studio
Already have MSDN with Team System Test edition, how do I....	visual-studio
Expanding a Region will expand children in Visual Studio	visual-studio
What is keyboard shortcut to view all open documents in Visual Studio 2008	visual-studio
Re-enabling JavaScript debugging in IE7 with Visual Studio	visual-studio
"Visual Studio 2008 ""randomly"" hangs on test run"	visual-studio
Is there anyway to tell Visual Studio not to open all the documents when I load solution?	visual-studio
Huge AboutIconData block in add-in file	visual-studio
"Why does the Visual Studio IDE sometimes initialize the ""this.components object: and other times not?"	visual-studio
Visual Studio/C++: How to turn off certain first-chance exception debug messages?	visual-studio
Is it possible to disable command input in the toolbar search box?	visual-studio
Windows Mobile Device Emulator - how to save config permanently?	visual-studio
Attach to IIS7 with a macro?	visual-studio
Including eval / bind values in OnClientClick code	visual-studio
Is it possible to customize the colors of RockScroll's variable syntax highlighting?	visual-studio
Visual Studio 2008: make ctrl-k, ctrl-n (next bookmark) stay within the same file	visual-studio
How to get Visual Studio's designer to render CSS correctly in an ASP.NET Web User Control?	visual-studio
How can you automaticly insert a namespace for a Visual Studios snippet?	visual-studio
VisualStudio: How to save the obj folder somewhere else	visual-studio
How to keep Visual Studio debugger visualizers from timing out?	visual-studio
ReflectedSchemas folder in the user's AppData folder (Visual Studio)	visual-studio
C++ class - Increment and decrement attribute every N milliseconds	visual-studio
"What are the various ""Build action"" settings in VS.NET project properties and what do they do?"	visual-studio
"How can I stop Visual Studio (both 2005 and 2008) from crashing (sometimes) when I select the ""Close All But This"" option?"	visual-studio
Preventing Visual Studio from building all projects when debugging one	visual-studio
TFS annotate/blame summary report for a project	visual-studio
Visual Studio 2005 - 'Updating IntelliSense' hang-up	visual-studio
team system unit testing and configuration	visual-studio
How to Relocate Visual Studio project (.sln) file	visual-studio
Multi-lingual projects in Visual Studio	visual-studio
Flowcharting tool/add-in for Visual Studio	visual-studio
Is there a tool to alphabetize CSS definitions in Visual Studio?	visual-studio
"VS2008 crashes with ""Fatal Execution Engine Error"""	visual-studio
Visual Studio Keyboard Shortcut to automatically add the needed Using statement	visual-studio
Close all files in visual studio on exit	visual-studio
Why can't I debug?	visual-studio
Insert Tracepoint: how to set the default message?	visual-studio
VS2008 Solution Template	visual-studio
Visual Studio Task Panel	visual-studio
Can I Install Visual Studio 2008 Express with VS 2005 ?	visual-studio
Visual Studio behaves strangely while debugging with breakpoint conditions	visual-studio
Mixing Visual Studio versions OK?	visual-studio
How to setup non-admin development in Visual Studio 2005 and 2003	visual-studio
Check if application was started from within Visual Studio	visual-studio
How to remove projects/ solutions from Recent Projects window in Visual Studio 2005	visual-studio
Do you have any recommended macros for Microsoft Visual Studio?	visual-studio
How to add enviromental variable to VS solution (.sln )	visual-studio
Capture console output for debugging in VS?	visual-studio
Very slow response for Visual Studio 2005 Web Site Administration Tool	visual-studio
How can easily view the contents of a datatable or dataview in the immediate window	visual-studio
Visual Studio 2008 Fatal Execution Engine Error (7A2E0F92)	visual-studio
How do you build a debug .exe (MSVCRTD.lib) against a release built lib (MSVCRT.lib)?	visual-studio
Fastest way to insert replacement characters in Visual Studio	visual-studio
Smart tool (addin?) for creating class body from header file	visual-studio
Visual Studio: Build Solution vs Batch Build	visual-studio
PDB files in VisualStudio bin\debug folders	visual-studio
Visual Studio 2005 ERROR: An error occurred generating a bootstrapper: Invalid syntax.	visual-studio
VS 2005 Toolbox Messed Up	visual-studio
Include directory in VS 2003	visual-studio
String Compare not working in Visual C++ 2005	visual-studio
Class Designer in Visual Studio - is it worth it?	visual-studio
"""Microsoft Visual C# IntelliSense has stopped working"" in project referencing F#"	visual-studio
Icon of project in Visual Studio	visual-studio
How do I compile an ASP.NET website into a single .DLL?	visual-studio
"Per-filetype ""View whitespace"" setting in Visual Studio"	visual-studio
How do you create a Visual Studio Solutio File (.sln) in the same directory as the web project	visual-studio
How to programatically add a tracepoint for Visual Studio?	visual-studio
Error viewing csproj property pages in VisualStudio2005	visual-studio
How to remove paths from tabs in Visual Studio 2008?	visual-studio
