text	label
how do i create a map with a type parameter of class	scala
Can I limit the size of the array in scala?	scala
Restrictions in trait mixing	scala
Simple Scala actor question	scala
Scala: Where do I find an OS project written in scala?	scala
Understanding the different dispatchers in Akka 2	scala
How do you code up a pattern matching block in scala?	scala
How to write eclipse rcp applications with scala?	scala
How to create a compiler Action for SBT	scala
How do I extend scala.swing?	scala
scala override methods in child object of class	scala
"Scala programmer - ""should there be one obvious way to do it"" or ""more than one way to do it""?"	scala
Can one create Sized Types in Scala?	scala
What is the motivation for Scala assignment evaluating to Unit rather than the value assigned?	scala
Scala and Java Real-Time System	scala
What is the easiest way to deeply clone (copy) a mutable Scala object?	scala
How in Scala to find unique items in List	scala
Traits vs template	scala
How to get Ponter/Reference semantics in Scala.	scala
Using Sub-Types And Return Types in Scala to Process a Generic Object Into a Specific One	scala
Streaming Video In Scala Designer 5	scala
What is the purpose of Scala language?	scala
"What's the ""functional way"" to avoid passing state-choosing context down the call stack?"	scala
Scala AST in Scala	scala
Practical use of futures? Ie, how to kill them?	scala
Using comparision operators in Scalas pattern matching system.	scala
Serializing a JSon object using lift-json [scala]	scala
Scala libraries and frameworks	scala
Scala project does not automatically build in Eclipse	scala
Scala @ operator	scala
How to do something like this in Scala?	scala
Why scala not allowing '$' identifier in case statement?	scala
A question about Scala Objects	scala
How do I alias the scala setter method 'myvar_$eq(myval)' to something more pleasing when in java?	scala
Concrete classes with abstract type members	scala
Creating a parametric graph type in Scala	scala
Ant-Ivy-Scala Template: any suggestions on improvements?	scala
Does Scala have a library method to wrap nullable return values in an Option?	scala
GAE JCache NumberFormatException, will I need to write Java to avoid?	scala
Read entire file in Scala?	scala
Is it possible to add a method to a built-in type in Scala?	scala
Scala API design; a service which returns a Set<I> where I is some interface (abstract/trait)	scala
Can I use a block when defining a Scala anonymous function?	scala
Scala collection type for filter	scala
"Scala puts precedence on implicit conversion over ""natural"" operations... Why? Is this a bug? Or am I doing something wrong?"	scala
Extend scala class that extends ordered	scala
Generating javadoc for project involving scala modules	scala
What is the standard way to optimise mutual recursion in F#/Scala?	scala
How do I get started developing for a web using Scala?	scala
is there any scala network library with actor model	scala
Easiest way to do idle processing in a Scala Actor?	scala
"Why ""avoid method overloading"" ?"	scala
Existential Quantification over Values	scala
Why scala's TreeSet returns SortedSet	scala
noClassDefFound error using Scala Plugin for Eclipse	scala
What does the remote-actor framework do if trying to write to a client which is no longer there?	scala
what is the Benefit from Scala ?	scala
How to check existence of a program in the path	scala
Best Scala imitation of Groovy's safe-dereference operator (?.)?	scala
Alternative way of implementing a groupBy method in Scala?	scala
Equality relations in Scala	scala
How do I configure jEdit for Scala projects?	scala
Scala extra parentheses printout	scala
Is it possible to curry the other way around in Scala?	scala
fold list of tuples in scala with destructuring	scala
Do self: T => and this: T => have the same meaning when defining a trait?	scala
Scala's simple-build-tool doesn't appear to run tests	scala
Automated Java to Scala source code conversion?	scala
Why Option[T] ?	scala
Scala XML Building: Adding children to existing Nodes	scala
Is there a scala version of Python's Mechanize?	scala
Why cannot this.type be used for new instances	scala
Scala 2.8 - Potential problem with named arguments	scala
Could/should an implicit conversion from T to Option[T] be added/created in Scala?	scala
Scala inconsistant type signatures: Range.toList and Range.toArray	scala
Scala default values behavior	scala
How to script scala directly in JSP pages?	scala
The Scala way to use one actor per socket connection	scala
Reflection API for Scala	scala
Learning Sclala.	scala
Why does one of these statements compile in Scala but not the other?	scala
Scala methods ending in _=	scala
How can I use the Scala program schema2src?	scala
Itaerate over a list, returning the current, next and the element before current	scala
Scala and tail recursion	scala
Partitioning an Iterator in scala 2.7.5	scala
How to print a Map in Scala	scala
Lift and Eclipse RCP Integration	scala
Scala: overflow despite use of Long when adding	scala
Discovering a functional algorithm from a mutable one	scala
How would be a functional approach to shifting certain array elements?	scala
scala for yield setting a value	scala
How to designate a thread pool for actors	scala
Use 'map' and stuff on Scala Tuples?	scala
If the Nothing type is at the bottom of the class hierarchy, why can I not call any conceivable method on it?	scala
How to handle XML Character reference in scala?	scala
Implementing Seq[T] for CPS-Classes	scala
Scala, repeat a finite list infinitely	scala
Why does a SelectionKey registered to a DatagramChannel return a SelectableChannel in Scala but not Java?	scala
Scala equivalent of Ruby's map.each?	scala
Scala wont pattern match with java.lang.String and Case Class	scala
Step-by-step explanation of Scala syntax used in Wikipedia quick sort example	scala
Parse error of nested tuples in scala	scala
Scala equivalent to Haskell Monads	scala
How to access a field's value via reflection (Scala 2.8)	scala
Named constructors in Scala?	scala
Is Scala the next big thing?	scala
Sala and html parseing	scala
Processing messages concurrently in an Actor	scala
How can I iterate a list of lists in scala?	scala
Why and when do I need to follow a method name with _?	scala
An efficient technique to replace an occurence in a sequence with mutable or immutable state	scala
Can you return an unevaluated function in scala?	scala
Can Scala's Actor framework handle 10.000 actors without stack problems?	scala
Scala: how to specify varargs as type?	scala
What is the Scala equivalent of Java's ClassName.class?	scala
Can I use a scala class which implements a java interface from Java?	scala
How can I force the type of an array when initialized in Scala?	scala
Static inner classes in scala	scala
Learning Scala or Haskell	scala
Conflicting nested inherited traits	scala
scala 2.8 breakout	scala
"How does the ""specs"" BDD framework for Scala work?"	scala
Type Inference on Method Return Type	scala
Is there any Wicket-like web framwork to use with Scala (not lift)?	scala
Can extractors be customized with parameters in the body of a case statement (or anywhere else that an extractor would be used)?	scala
Cost of using repeated parameters	scala
Is it bad practice to send an  actor a message from something which is not an actor?	scala
scala: Method\Operator Overloading	scala
Can First-class functions in Scala be a concern for allocating a large PermGen Space in JVM?	scala
Capturing from java Iterators and Enumerators	scala
Using Either to process failures in Scala code	scala
Why does Scala create a ~/tmp directory when I run a script?	scala
graph library for scala	scala
Is it possible for Scala to have reified generics without changing the JVM?	scala
scala Slider throws casting exception	scala
What is a simple way to receive SNMP traps in Scala?	scala
How do I break out of a loop in Scala?	scala
How should I specify the type of JSON-like unstructured data in Scala?	scala
"Is the scala 2.8 collections library the ""longest suicide note in history"" ?"	scala
Table Cell renderer using Nimbus and Scala	scala
Enums in Scala with multiple constructor parameters	scala
How do I setup multiple type bounds in Scala?	scala
Function.tupled and placeholder syntax	scala
Why is there no string interpolation in Scala?	scala
How to add tracing within a for comprehension?	scala
Scala equivalent to python generators?	scala
Logging in Scala	scala
Scala/Lift question rss feed fetch	scala
Alternatives to multimethods in Scala or Jython	scala
ORA-01031: insufficient privileges creating JMS connection to Oracle topic	oracle
Oracle performance using functions in where clause	oracle
Oracle ProC ORA-12547	oracle
BPEL for data synchronization	oracle
What is the best way to escape non-format characters in Oracle's to_char?	oracle
How update oracle heterogeneous services metadata?	oracle
Storing Waveforms in Oracle	oracle
Unit testing for PL/SQL	oracle
Oracle and auto_increment/identity	oracle
Oracle TNS names not showing when adding new connection to sqldeveloper	oracle
How to avoid storing credentials to connect to Oracle with JDBC?	oracle
Why isn't querying a JDBC-compliant database from Oracle as easy as pie?	oracle
Inserting an array within an object construction, constructed based on a query	oracle
How to execute an Oracle stored procedure via a database link.	oracle
Conversion tool for MS-Excel spreadsheets with macros and VB to Oracle?	oracle
Search All Fields In All Tables For A Specific Value (Oracle)	oracle
How to wrapp an Oracle stored procedure in a function that gets executed by a standard SELECT query?	oracle
Requirements for connecting to Oracle with JDBC?	oracle
Defining Collections with variables	oracle
notification when alter occurs on oracle database	oracle
installing Oracle Instantclient on Linux without setting environment variables?	oracle
Oracle 10gr2: enforce a date range	oracle
Oracle: Program not forking correctly in SELECT CASE statement on a date	oracle
How to access Subversion from Oracle PL/SQL ?	oracle
Oracle deadlock detection tool	oracle
How To Check for an Index in Oracle	oracle
User Privileges	oracle
TKProf Output: SQL*Net message from client	oracle
How do you programatically identify a stored procedure's dependancies?	oracle
Can Ruby on Rails connect to Oracle/RDB on Mac OS X or Windows?	oracle
Installing Oracle 10 ODP.NET on Microsoft Windows 2008 Server 64bit	oracle
Testing for a valid date in a oracle procedure's parameter	oracle
Differences between two analytic queries	oracle
How to disable Oracle XE component which is listening on 8080?	oracle
How do you detect if there is an index for a specific column on a table in Oracle?	oracle
Will Pro*C work with MSVC 6?	oracle
help on integrating oracle BI into existing application	oracle
Oracle Data Dump and Data Restore	oracle
How should I store a Guid in Oracle	oracle
Is there a .Net interface to Oracle SQLPLUS?	oracle
Is there a way to get types/names of an unknown db query without executing it?	oracle
Oracle SYS_CONNECT_BY_PATH hitting 4000 character limit	oracle
oracle - how to multiple statements with .NET	oracle
Best practices: .NET: How to return PK against an oracle database?	oracle
Retrieve value of an xml element in Oracle PL SQL	oracle
Oracle SQL Developer: sharing configuration via Dropbox	oracle
Casting DateTime to OracleTimeStampTZ	oracle
difference between a User and a Schema in Oracle?	oracle
The CASE statement in PL/SQL	oracle
Dropping a connected user from an Oracle 10g database schema	oracle
Oracle Text: How to sanitize user input	oracle
SQLPlus settings to generate tab-separated data file	oracle
What's the best type 4 Oracle JDBC driver?	oracle
Java library or code sample to parse CTXCAT query syntax (for Oracle CATSEARCH)	oracle
adding oracle's timestamp to query results	oracle
What is the default URL for APEX for an Oracle XE installation?	oracle
Joining other tables in oracle tree queries	oracle
Oracle: best way to search over a range of values?	oracle
How can multiple rows be concatenated into one in Oracle without creating a stored procedure?	oracle
Is there a way to do full text search of all oracle packages and procedures?	oracle
how to create a stored procedure in oracle which accepts array of parameters	oracle
Oracle: any replacements for DBMS_OUTPUT package?	oracle
#define Equivalent for Oracle SQL?	oracle
Identify a table with maximum rows in Oracle	oracle
Database history for client usage	oracle
How to get all tables that have FKs to another table?	oracle
In Oracle, is there a function that calculates the difference between two Dates?	oracle
How to deploy web service through oracle enterprise manager [Java]	oracle
Importing selective data using impdp	oracle
How to make Oracle error messages more verbose?	oracle
Oracle User Management	oracle
Oracle Database 10g VIEW performance	oracle
SQL: the semicolon or the slash?	oracle
Oracle Analytics inside Cursor	oracle
Oracle SQL Expert Certification 1Z0-047	oracle
Using Oracle Database Migration Verifier	oracle
Insufficiente privileges when creating a trigger for a table in another schema	oracle
How to catch a unique constraint error in a PL/SQL block?	oracle
Is there a way of selecting the contents of a ref cursor as part of a SQL Select statement?	oracle
Application crashing when talking to oracle unless executable path contains spaces	oracle
Performance of Remote Materialized views in Oracle	oracle
"Oracle, calling PL/SQL issues from within SQL-Plus file x.sql says my_function ""may not be a function"""	oracle
Oracle Resource Manager Plan Design	oracle
Oracle all foreign key references	oracle
"Oracle ""Partition By"" Keyword"	oracle
How to encode string in Oracle?	oracle
PL-SQL: getting column data types out of query results	oracle
How to load Java Stored Procedure through JDBC into Oracle 10g?	oracle
How to put more than 1000 values into an Oracle IN clause	oracle
Oracle 10g ODBC: SQLBindParameter(SQL_BIGINT) succeeds, SQLExecute fails, but there are no diagnostic errors	oracle
Lost RPC connection to remote Agent error with Oracle connected to Informix	oracle
Error when converting XML from a CLOB column to XMLType colum	oracle
ORA-28579: network error during callback from external procedure agent	oracle
Sessions with clustered instances of Oracle Application Server	oracle
Oracle: Does a 10g oracle client work with an 11g server?	oracle
Oracle optional relationship	oracle
oracle pl/sql ora-01722 error	oracle
Oracle recommendations for high volume writes and low volume read.	oracle
Oracle Connection and nls_lang	oracle
Oracle / Python  Converting to string -> HEX (for RAW column) -> varchar2	oracle
Oracle logon trigger not being fired.	oracle
Converting SQL Server date format to Oracle	oracle
Oracle: loading a large xml file?	oracle
ORM for ASP.net, ORACLE, looking for a solution.	oracle
Faster Insert Oracle Hash Cluster Table	oracle
How do you know what a good index is?	oracle
Why can't I reference a user defined type field when using nested queries?	oracle
Prevent Oracle minus statement from removing duplicates	oracle
oracle subselect with dynamic table and column	oracle
Is there any good oracle podcasts	oracle
Accessing Oracle Database from C#	oracle
What exactly is the deal with oracle connection identifiers separated by a period	oracle
How do I turn off Oracle password expiration?	oracle
'CONTINUE' keyword in Oracle 10g PL/SQL	oracle
Binding ASP.NET GridView to an Oracle SYS_REFCURSOR	oracle
How do I get the 'size' of document stored in an oracle blob column in a readable form using SQL?	oracle
Oracle Ref Cursor Vs Select into with Exception handling	oracle
Oracle XE or MySQL , which one I should choice?	oracle
Oracle SQL Developer not responsive when trying to view tables (or suggest an Oracle Mac client)	oracle
Oracle PL/SQL - Are NO_DATA_FOUND Exceptions bad for stored procedure performance?	oracle
Abort a PL/SQL program	oracle
How to average time intervals?	oracle
How do I remember which way round PRIOR should go in CONNECT BY queries	oracle
Is there a way to peek inside of another Oracle session?	oracle
Understanding Lob segments (SYS_LOB) in oracle?	oracle
Oracle sql types over dblink	oracle
Oracle INSERT giving error in C#.	oracle
oracle: how do I get the sequence number of the row just inserted?	oracle
How to trunc a date to seconds in Oracle	oracle
ORA-08177: can't serialize access for this transaction	oracle
Is there any way to have the JBoss connection pool reconnect to Oracle when connections go bad?	oracle
How do I automatically reset a sequence's value to 0 every year in Oracle 10g?	oracle
Free oracle development tools.	oracle
How to obtain the list of Oracle's SIDs	oracle
My oracle listner to shuts itself down, what could be happening?	oracle
REF CURSOR versus TABLE function in Oracle	oracle
Oracle10 and JDBC: how to make CHAR ignore trailing spaces at comparision?	oracle
"""Disable"" trasactions in Oracle"	oracle
How do I call an ORACLE function from OCI ?	oracle
Oracle Query Tuning (Duplicate table access)	oracle
Optimising a SELECT query that runs slow on Oracle which runs quickly on SQL Server	oracle
Is Oracle RDBMS more stable, secure, robust, etc. than MySQL RDBMS?	oracle
Working with date ranges in PHP/Oracle	oracle
TransactionTimeout with Oracle 11g	oracle
Copying data between Oracle schemas using SQL	oracle
Oracle Gotchas for An Experienced Newb	oracle
Oracle: how to UPSERT (update or insert into a table?)	oracle
how to write a pl/sql code block that prints out contents of cursor that is out parameter from stored proc	oracle
Find out name of PL/SQL procedure	oracle
How do I go about using Microsoft Access (2003/2007) to interface with an Oracle (10g) DB to produce reports?	oracle
Hibernate Update does Not Update Anything	hibernate
Hibernate casts BigDecimal instead of Integer	hibernate
Why use Hibernate/nHibernate?	hibernate
Determining ManyToMany vs OneToMany using ClassMetadata	hibernate
hibernate - projection a component	hibernate
hibernate insert into select	hibernate
Proper way to autowire a Hibernate Session in a Spring Transaction JUnit test	hibernate
Seqential & continuous invoice number in Hibernate / ColdFusion ORM?	hibernate
Hibernate - apply locks to parent tables in polymorphic queries	hibernate
before calling session.gettransaction, do I have to ensure one exists?	hibernate
Hibernate orm for a view	hibernate
hibernate DAO	hibernate
Hibernate Second level Cache <<net.sf.ehcache.hibernate.EhCacheProvider>>	hibernate
Storing Dates in Oracle via Hibernate	hibernate
cancel hibernate query	hibernate
What's the default value of the Hibernate property hibernate.jdbc.factory_class?	hibernate
How to specify connection release modes in Hibernate?	hibernate
Using hibernate hbm2ddl.auto=update : How can I alter column not to require value anymore?	hibernate
Hassle with Hibernate and Spring and Dynamic Proxies	hibernate
queries with hibernate	hibernate
Hibernate: bad performance when removing element from many-to-many relation.	hibernate
Terracotta With Hibernate and EHCache	hibernate
hibernate OneToMany List ordering persisting but reversing?!	hibernate
Best way to update some fields of a detached object on Hibernate?	hibernate
Workarounds for Hibernate's lack of delete-orphan support for one-to-one and many-to-one relationships?	hibernate
Upgrade hibernate-annotations and hibernate-validator	hibernate
Hibernate Mapping Through Another Entity	hibernate
hibernate how to retrieve a hierarchy object	hibernate
Hibernate transaction duplicate problem	hibernate
hibernate Lock wait timeout exceeded;	hibernate
How to reuse existing connection in Open Session In view pattern implementation of Hibernate?	hibernate
How do I left join tables in unidirectional many-to-one in Hibernate?	hibernate
hibernate - component mapping vs custom value type	hibernate
Hibernate3: Self-Referencing Objects	hibernate
Get the entity previous  version in Hibernate Envers	hibernate
Setting up NHProf for Hibernate	hibernate
How can this be done with (N)Hibernate?	hibernate
Hibernate calls flush on find- causes not-null error	hibernate
Hibernate running random queries.	hibernate
Why does Hibernate/JDBC/MySQL drop connections after a day or so?	hibernate
Hibernate Unidirectional Parent/Child relationship - delete() performs update on child table instead of delete	hibernate
Hibernate increment starting number	hibernate
Retrieve auto-detected hibernate dialect	hibernate
How to lazy load a one-to-one composition via hql	hibernate
Get Criteria by associationPath	hibernate
hibernate and netbeans application	hibernate
How much overhead do frameworks like Hibernate bring?	hibernate
Hibernate constraint violation/error rolling back	hibernate
Loading Hibernate property from an external source (HashMap)	hibernate
Hibernate query with fetch question	hibernate
one-to-many mapping // how to map an association of legacy tables (Hibernate)	hibernate
hibernate creates problem for table with composite primary key while generating hibernate classes with eclipse	hibernate
Using Hibernate Criteria API To Query Many-To-One Relationships with Projections	hibernate
How Configure Hibernate for develop Test	hibernate
Strategies for designing a database (being accessed by hibernate) which will have alot of archivial data.	hibernate
Hibernate Annotation Many To Many delete problem	hibernate
Hibernate: How declare foreign key without having to code association methods in the domain object?	hibernate
Hibernate load UserType object from repository	hibernate
How to get hibernate-entitymanager to work with JTA out of JBoss?	hibernate
What is the BEST way to pull data out of the hibernate layer and into another tier?	hibernate
Hibernate ConstraintViolationException in join table	hibernate
Hibernate HQL query - complicated	hibernate
hibernate cascade deletion	hibernate
Controlling Hibernate's generated subselect	hibernate
How do I join tables on non-primary key columns in secondary tables?	hibernate
HQL Join Fetch question: aliasing association	hibernate
How I can disable the second-level cache of some certain entities in Hibernate with changing annotations	hibernate
Does Hibernate auto-rollback programmatic transaction for unhandled exceptions?	hibernate
Is there a way to combine streaming data retrieval with hibernate?	hibernate
specifying constraint name in hibernate mapping file	hibernate
how to set query to be read uncommitedd?	hibernate
Search result was due to field in Hibernate Search	hibernate
Hibernate, Null values and nativeSQL	hibernate
Having an issue with org.hibernate.SessionException: Session is closed! in Hibernate	hibernate
Hibernate lazy initialization help	hibernate
Hibernate One-to-Many cascade efficiency	hibernate
Hibernate/mysql connection pooling	hibernate
Hibernate:  Projection of a many-to-one in a Criteria	hibernate
Hibernate - Problem in parsing mapping file (.hbm.xml)	hibernate
Hibernate Criteria query with restricted associations	hibernate
Hibernate Criteria: Eagerly load ManyToMany collection	hibernate
How do I map a Map from an Entity to a Value with hibernate annotations?	hibernate
hibernate: Is this mapping allowed?	hibernate
How can I create a hibernate collection that will be re-read every time I request it?	hibernate
Hibernate problems with Auto Increment ID MYSQL 5	hibernate
Hibernate polymorphic query	hibernate
What's the difference between different mapping types in Hibernate?	hibernate
Hibernate unidirectional one to many association - why is a join table better?	hibernate
hibernate one to one mapping example	hibernate
Hibernate bidirectional parent/child problem	hibernate
Zero Downtime with Hibernate	hibernate
queries in Hibernate polymorphism	hibernate
hibernate order by association	hibernate
problem saveOrUpdate object Hibernate (a different object with the same identifier session)	hibernate
How to transfer data from one database to another with Hibernate?	hibernate
Querying ManyToMany relationship with Hibernate Criteria	hibernate
How do I rewrite this hibernate-mapping with annotations?	hibernate
hibernat sesson problem new	hibernate
Hibernate flush doesn't update database	hibernate
ManyToMany in Hibernate without composite keys	hibernate
hibernate manytomany	hibernate
Turn off Hibernate Logs for certain query	hibernate
Ignore Hibernate @Where annotation	hibernate
Obtaining a new session from Hibernate for a background thread.	hibernate
hbm2ddl on a column based on GenericEnumUserType	hibernate
hibernate: LazyInitializationException: could not initialize proxy	hibernate
Hibernate Save strange behaviour	hibernate
Hibernate EntityManager + JOTM: transactions are not used	hibernate
Hibernate: ORDER BY using Criteria API	hibernate
what are annotations in hibernate?	hibernate
Hibernate @OrderBy with referenced class	hibernate
Getting list in order, mapped by join table	hibernate
Nhibernate multiple component properties of the same type in a class	hibernate
hibernate object vs database physical model	hibernate
Error in hibernate constraint	hibernate
In hibernate statistics whats the difference between load and fetch	hibernate
Why size of lucene index increased if i index the same data?	hibernate
Optional parameters with named query in Hibernate?	hibernate
HQL : Getting the primary key of an object.	hibernate
hibernate result ordering	hibernate
"Hibernate fetching strategy - when to use ""join"" and when to use ""select""?"	hibernate
Hibernate Question on Sessions	hibernate
Hibernate with ZK	hibernate
hibernate:  foreign key is primate key	hibernate
Hibernate: Criteria vs. HQL	hibernate
"How to work with zero dates (""0000-00-00"") in Hibernate?"	hibernate
Is possible to set validation order with Hibernate Validator?	hibernate
Hibernate session not getting created.	hibernate
Left outer join fetch doesn't fill map collection properly (HQL)	hibernate
what the heck is a JPA configuration?	hibernate
Hibernate/Spring application - export to CSV	hibernate
Remove dinamically an ordering to the result set in org.hibernate.Criteria	hibernate
Transactional strategy for Hibernate L2 Cache	hibernate
HQL order by within a collection	hibernate
Hibernate hbm2ddl and Ms SQL Server: Long as column of numeric data type	hibernate
Hibernate JPA Sequence (non-Id)	hibernate
How do you programmatically turn off eager fetching with hibernate?	hibernate
Hibernate Immutable Value Object	hibernate
Dynamic mapping in hibernate?	hibernate
Hibernate 2nd level cache + Ehcache issue when trying to get data (List of object) from cache memory	hibernate
Hibernate mappings: Splitting up the file	hibernate
How to stop Hibernate from eagerly fetching many-to-one associated object	hibernate
Hibernate/JPA - annotating bean methods vs fields	hibernate
Using Hibernate to 'order by' a column which having a expression(sum, max, ...)?	hibernate
Hibernate: Connect to MySQL without Username or Password	hibernate
Update of of Composite Entity fails	hibernate
Why would Spring's HibernateTemplate's loadAll() method generate updates for each row?	hibernate
Hibernate dynamic instantiations with collections, is it possible?	hibernate
"hibernate ignores fetch=""join"" on a collection when navigating the object tree with iterator"	hibernate
Converting a HQL-query which includes elements() to Criteria API	hibernate
Mouse events for an NSSegmentedCell subclass?	cocoa
Hot to select items in NSOutlineView without NSTreeController?	cocoa
NSPopUpButtonCell inside custom cell does not pop up when clicked.	cocoa
Find Installed applications in cocoa	cocoa
my NSDateFormatter works only in the iPhone simulator	cocoa
How to implement gradient button bar in Cocoa	cocoa
Interface Builder UIDatePicker	cocoa
why co-cocoa pr-programmers st-stutter...	cocoa
Is there a difference between delegate/selector and target/action?	cocoa
Posix Error 14 (bad address) on open read stream in Cocoa.  Hints?	cocoa
Getting a unique ID for a window of another application	cocoa
What are the most valuable parts of Computer Science studies for Cocoa developers?	cocoa
Is an NSMutableString in this case more efficient than NSString?	cocoa
Easy way to make a UILabel cover and exactly match contents of a UITextField?	cocoa
Multiple keys held down in Cocoa (OS X)	cocoa
Drawing once per frame in Cocoa	cocoa
Cocoa/Objective-C NSProcessInfo weirdness...	cocoa
How should I return an NSError object from a delegate method?	cocoa
What Cocoa/Core Foundation helper functions do you wish you knew about 2 years ago?	cocoa
Why the splash window canâ€™t show before the App lunch?	cocoa
How do I implement a customized list in Cocoa?	cocoa
Create NSString by repeating another string a given number of times	cocoa
Can NSAlert Be Used to Create a Floating Window?	cocoa
Cocoa: Dictionary with enum keys?	cocoa
Multiline NSTokenField and the return key	cocoa
How do I fix the height of my view after collapsing NSSplitView?	cocoa
Cocoa Helper app	cocoa
Find all Folders in Root Directory	cocoa
Limiting the number of objects in NSArrayController	cocoa
Is there a simple way to combine a text and icon in an NSCell in Cocoa?	cocoa
pboard types will be deprecated	cocoa
Create an URI for an application	cocoa
How to do string manipulation in an NSValueTransformer?	cocoa
Asyncsocket VS NSstream	cocoa
Shared Objects in Cocoa	cocoa
Updating the image of a NSStatusItem	cocoa
LSUIElement application that starts a window with an application menu?	cocoa
Why am I getting these Errors in the Console when Debugging in XCode?	cocoa
when close the top window ,how to let the focus to the next level window?	cocoa
Core data, NSArrayContainer Arraycontent of many arrays	cocoa
Regular expressions in Cocoa / Objective-C.	cocoa
Speeding up creation of NSDictionary from XML?	cocoa
File Watcher in Cocoa	cocoa
NSTableView, multiple cells and bindings	cocoa
How do I draw a badge on my Dock icon using Cocoa?	cocoa
Custom NSControl target/action howto!	cocoa
NSString's initWithData:encoding: return type issue	cocoa
Cocoa: Memory management with NSString	cocoa
Subclassing a NSTextField	cocoa
How to get value from NSTextField(in cocoa)?	cocoa
NSOutlineView not doing what it has should do in it's subclass.	cocoa
NSTableView Troubles	cocoa
Upload and download data from server with cocoa?	cocoa
stitch picture in iphone	cocoa
cocoa+ unmount removable storage	cocoa
Integrate NSStepper with NSTextField	cocoa
List of all users and groups	cocoa
Converting enum into a class hierarchy	cocoa
How to create a binding for NSApp.dockTile's	cocoa
Cocoa Check for Updates	cocoa
Unit Test to verify object getting deallocated	cocoa
link an Array Controller to an Array in XCode via outlets	cocoa
how to transform array argu from object_c to javascript?	cocoa
cocoa Document-based applications	cocoa
Using Calender Store.	cocoa
Cocoa mini toolbar under table (add, remove)	cocoa
Why isn't my sheet attached to the window it's run for?	cocoa
Getting to the managed objects in NSTableView	cocoa
Is it possible to observe a readonly property of an object in cocoa?	cocoa
Move focus to newly added record in an NSTableView	cocoa
UIWebView in multithread ViewController	cocoa
How can I use custom animations for onOrderOut in Core Animation?	cocoa
CocCoa Application	cocoa
How do I convert Cocoa co-ords from top left == origin to bottom left == origin	cocoa
Creating a Core Data Inverse Relationship	cocoa
Have you ever used NSZoneMalloc() instead of malloc()?	cocoa
Is it possible to have a binding that combines more than one key path?	cocoa
A View Controller that can be instantiated both programatically and in IB?	cocoa
Parsing unsupported date formats in via Cocoa's NSDate	cocoa
How to create an NSString with one random letter?	cocoa
Fullscreen Key Down Actions	cocoa
Core Data vs sqlite3	cocoa
How do you make your App open at login?	cocoa
Load SWF inside NSView	cocoa
cocoa + dynamic text labels on NIB file	cocoa
Garbage collection of Core Foundation objects	cocoa
Error while checking if a file exists	cocoa
Why doesn't Cocoa like this URL?	cocoa
How do I get the inner/client size of a NSView subclass?	cocoa
Passing a native pointer to performSelectorOnMainThread's withObject argument?	cocoa
Explanation of Cocoa @selector usage.	cocoa
Why does the dialog I created in Leopard look terrible in Tiger?	cocoa
Why the Observer in NSNotification called twise....    ?	cocoa
What's the best way to draw a bunch of (~200) colored rectangles in Cocoa?	cocoa
How do I create Cocoa interfaces without Interface Builder?	cocoa
How to show a local image in the webview?	cocoa
com.finder.desktopservices asks for admin password when copying files	cocoa
How would you put an Image next to a text cell for only parent rows in an outline view?	cocoa
Forcing Reading of a Text Field Before Dismissing Modal Dialog in Cocoa	cocoa
How do I convert NSString to NSData?	cocoa
NSBezierPath / Line Intersection / flatten	cocoa
loading custom framework in iphone	cocoa
Can I start a thread by pressing a button in a cocoa interface and keep using interface while thread runs	cocoa
NSScrollView Bar not scrolling through NSTableView rows	cocoa
Set default values for a global variable in a custom class?	cocoa
Second Frontmost App?	cocoa
NSArray to C array	cocoa
How do I create an FSRef from a NSString containing a path?	cocoa
CPAN/gem-like repository for Objective-C and Cocoa?	cocoa
Cocoa bindings: custom setter methods?	cocoa
How to make an iTunes like (playlists, library) left-sided (collapsible) navigation bar?	cocoa
How to use @sum with CoreData	cocoa
Animating rows in an NSTableView	cocoa
"How to prevent the OS X text layout engine from automatically ""flipping"" lines with right-to-left text?"	cocoa
Enabling Save for an NSDocument	cocoa
How do you enable javascript in a WebView	cocoa
How to define the WebPluginMIMETypesFilename in the plist of a safari webplugin project?	cocoa
How to color Text in Popup menu of NSComboBox?	cocoa
Should I use NSDecimalNumber to deal with money?	cocoa
How do I create a nice -description method that nests recusively like NSArray	cocoa
How do I dismiss a sheet with the escape key?	cocoa
PyObjc vs RubyCocoa for Mac development, Which is more mature?	cocoa
Renaming keys in NSMutableDictionary	cocoa
Multiple views and source list in a Core Data app	cocoa
Double click a NSTableView row in Cocoa?	cocoa
Deleting A Row From An Outline View.	cocoa
Best resource to learn application programming? (.Net/Cocoa/etc)	cocoa
Should +initialize/+load always start with an: if (self == [MyClass class]) guard?	cocoa
Which method of checking to see if a NSDictionary contains a particular key is faster?	cocoa
Change Alpha on Main Window - Cocoa	cocoa
In cocoa, Is there a proper way to handle overlapping NSView siblings?	cocoa
[NSPredicateRowEditorTemplate templatesWithAttributeKeyPaths:inEntityDescription:] for to-many key?	cocoa
What kind of category methods do you use to make Cocoa programming easier?	cocoa
Opening links but not iFrames in webview	cocoa
How to give NSWindow a particular background color	cocoa
Database Results in Cocoa	cocoa
How can I refresh core plot without returning from a method?	cocoa
How to tell if the user's using 24 hour time using Cocoa	cocoa
find natural block size of the media being used by file handle	cocoa
In Cocoa, what is the best way to change the cursor when hovering over a circular view?	cocoa
Highlight NSToolbarItems	cocoa
Why is my comparing if statement not working?	cocoa
Key Value Observing in Cocoa, introspecting the change property	cocoa
Observing an NSMutableArray for insertion/removal	cocoa
Why does Cocoa returns an empty string occasionally?	cocoa
Using NSOperation for threading creates too many objects	cocoa
how do I package support files in a cocoa app	cocoa
Create DMG file	cocoa
Using toolbar & views on Cocoa	cocoa
Which delegate method I should use When I cliked on a textfield?	cocoa
Using command as ctrl in a Mac OS X terminal	osx
How to port a Cocoa app to iPhone-OS?	osx
Create a Mac Application Installer and Passing Arguments on Launch	osx
Menu of app in Status Bar wont work on Snow Leopard	osx
Is it possible to select a specific tab in OSX Terminal.app using keyboard shortcuts?	osx
How to simulate a low level keypress on os x?	osx
Why is it allowed to write to / on MacOSX as normal user?	osx
mac osx development environment	osx
Change cursor in GL fullscreen on OSX using cocoa?	osx
Mac OS X 10.5 Apache and Subversion upgrade alternatives	osx
xUnit Testing Framework for Mac/iPhone	osx
is there a way to eject all external hard drives from the command line? (OS X)	osx
.app OSX package problems on removable media.	osx
Guides/ tutorials for beginner OS X app development?	osx
Mac Browsers - Is IE5.5 for the Mac officially dead?	osx
What's the best way to remove all .svn directories throughout a directory hierarchy on Mac OS X?	osx
OS X Keychain's Password Assistant feature via Terminal	osx
CGWindowID from AXUIElement	osx
How to use notificationconf?	osx
Is there sth like Microsoft's TechNet or MSDN subcriptions for Apple, too?	osx
What's the best way to find if the processor type is PPC or Intel in Cocoa? (Do I have to use Carbon?)	osx
Good Editors for Web Development on OS X?	osx
Unique hardware ID in MacOSX	osx
Best location for database file in Mac OSX	osx
How can I eliminate dead keys on Mac OS X with international keyboard?	osx
line-end agnostic diff?	osx
Is OS X Installer package postflight localization supported?	osx
Fastest way to navigate through files in TextMate?	osx
Setting up an ftp server on OSx server edition	osx
How to instal libgluezilla for MAC OS X	osx
Broken Java Mac 10.6	osx
Mac os x Terminal.app's buffer and screen command	osx
Get file creation time with Python on Mac	osx
Getting the absolute path of a command-line app on OS X	osx
Where is the code for the function under c in Screen's copy-mode?	osx
OSX API Question: Where does BlockZero live?	osx
On a Mac, within the shell, how can I tell that I have a GUI?	osx
Calculating hdiutil's compression ratio	osx
Linking error: Undefined Symbols, lots of them (cpp cross compiling)	osx
Test build of Cocoa application not compatible with tester's version of OS X.	osx
What's a good way to write a Cocoa front-end to an Erlang application?	osx
Mac OS replace ';' with new line on text file	osx
Save entire desktop state?	osx
Resources Of Macintosh Development	osx
Quickest way to get started with OS X app development?	osx
Global hotkey poller via python for Mac OS X	osx
Programmatically Change System Network (Proxy) settings	osx
[OSX .app] How to reference Resources folder in code	osx
Pitch Detection In Mac OS X	osx
Error in java swing application in Mac	osx
How does one tell if there is an active network connection on OS X?	osx
Determine if WindowServer is available?	osx
Help writing a DVB driver for OS X	osx
C++ FileIO Pointer Leak error	osx
Help with OSSpinLock* usage to replace a while(true) {sleep(1);}	osx
Applescript to launch iTunes with a specific library	osx
Open dot-file with dialogue in OSX	osx
Unable to have TTY switch for Ctrl-Alt F1 and Alt-F1...F6 in Mac	osx
How to be notified of the Minimize button being pressed in an OSX Window?	osx
What is the best Mac OS X software for making architectural diagrams?	osx
Mac OS java version problem for jar files	osx
Beginner question about XCode 3.1.1 and static libraries	osx
Problem building Ruby on Mac OSX Snow Leopard	osx
Focus-follows-mouse (plus auto-raise) in Mac OSX.	osx
Xcode gcc exit status 1	osx
Problem with Apache on Mac OS X	osx
Measuring bluetooth signal strength via AppleScript on Mac OS X	osx
How do you enforce the minimum OS requirements in a Cocoa app?	osx
Center an NSView within an NSScrollView	osx
creating setup for mac application	osx
Where is user specified data being stored on MacOS	osx
Test a site in Mac Firefox	osx
Using Mac for development	osx
How to tell whether a dylib is compiled for 10.6 or 10.5?	osx
Finding the path of a mounted network share on Mac OS X	osx
Is there any way to pass an NSArray to a method that expects a variable number of arguments, such as +stringWithFormat:	osx
Any good resource on processor scheduling/programming for Mac OS X?	osx
I need to develop a project involving hardware which should also work the same on Windows as well as Macs. Whats the way forward?	osx
Unable to build SciPy on OS X 10.5.7	osx
MacBook vs MacBook Pro for .NET development and other stuff	osx
Powerbook compiler queries	osx
Automatically compile any Java class when the file is dropped in a directory	osx
How to get blocks/grand central dispatch working in Snow Leopard	osx
What's the best Mac custom disk image creation app?	osx
I have an exe setup file. I want to make it compatible with Mac OS.	osx
How to close modal window when window is closed ?	osx
Font used in Quicksilver - Large Text?	osx
How to run a code when network connection changes on Mac OS X?	osx
OS X - terminal - $PATH and ${PATH}	osx
Is there any good free tool for the mac, to draw UML and object diagrams?	osx
localhost working 127.0.0.1 broken in Safari	osx
A simple way to generate tones / sine waves on mac? (ruby would be nice)	osx
XCode crashes on startup	osx
OSX: Environment variables pointing to application bundles?	osx
Getting the current stack trace on MacOSX	osx
How to make a dashboard widget in mac os x using python	osx
installing cairo on Mac OS Lion	osx
How can I increase the key repeat rate beyond the OS's limit?	osx
How to get the most of out laptop batteries	osx
Enabling italics in vim syntax highlighting for mac terminal	osx
How do I get the Mac OS X 'quick look' feature to be more programmer-friendly?	osx
How to get variable value of applescript in cocoa ?	osx
I already have PHP installed, what's the easiest (best) way to get GDLib installed?	osx
Code to record a screencast in MacOS	osx
How do I embed data into a Mac OS X mach-o binary file's TEXT Section?	osx
[OS X] What can cause dlopen: no suitable image found (can't map)?	osx
Appkit examples on OSX 10.6	osx
Testing on different version of Mac without buying OSX Server or multiple machines	osx
osx: how do I find the size of the disk i/o cache (write cache, for example)	osx
how to find keyboard in /dev on osx	osx
mac screensaver start event	osx
mac osx speech to text api How-to?	osx
SharePoint WSS 3.0 Integration with Mac OSX (either Safari or Firefox)	osx
Mac: reloading document in Chrome or Firefox?	osx
What is an *.rsd file on Mac OS X?	osx
intercepting keystrokes in OSX	osx
Using PackageMaker to run a script on install	osx
Talking head library for Mac OS X	osx
Macintosh C Creating a navigation window to choose an app	osx
Where to find volume mount icon on Leopard	osx
Is there a good Fogbugz client for Mac OS X?	osx
Distinguishing between HFS+ and HFS Standard Volumes	osx
Get short user name from full name	osx
ldconfig for Mac OS X	osx
Mac OSX fullscreen application problem	osx
"Set AWK delimiter to parse ""airport -s"" output"	osx
Distribute binary library on OSX	osx
Is there a way to install gcc in OSX without installing Xcode?	osx
What was the name of the Mac (68000) assembler?	osx
Gems not found with Passenger in conservative spawn mode on Mac OS X	osx
Installing mod_mono for ASP.NET on MacOSX Leopard	osx
How does the kRotateImage flag to ICADownloadFile work?	osx
Video streaming woes	osx
How do I enable more than 8-bit colors in Terminal.app?	osx
Best way to copy of move files with Objective-C?	osx
Is QuickSilver dead?	osx
Debugging NSObjectInaccessibleException - The NSManagedObject with ID:0x123456789  has been invalidated	osx
"Mac solution for ""safe"" C/C++ Standard Library functions?"	osx
How to insert customize check condition (eg JRE Check) in Package Maker, Mac	osx
Fonts in pdf documents screwed up when generated with latex (specifically, pdflatex) on mac osx.	osx
How can I determine the running Mac OS X version programmatically?	osx
Darwin: how to kill parent process without killing child?	osx
Running X11 Server on MacOS X - and connecting from a remote machine	osx
Is it safe to manipulate objects that i created outside my thread if i don't explicitly access them on the thread which created them?	osx
How to tab focus onto a dropdown field in Mac OSX	osx
Can MacOS be run in a VMWare type environment?	osx
Comparing Mac's and Unix manuals?	osx
Nokia E50 and mac internet sharing	osx
Remember window sizes and placement when unplugging and replugging second monitor.	osx
gdbinit conflict with Xcode debugging	osx
What is the difference between these two methods of accessing the SharePoint model?	sharepoint
MOSS FBA never asking for creds	sharepoint
How can I restrict the visibility of a custom list action to a newly defined group	sharepoint
Designing sharepoint pages - what can I use?	sharepoint
Secure only Login.aspx for a site	sharepoint
"Saving a document to SharePoint brings up ""Web File Properties"" dialog with incorrect metadata"	sharepoint
Deploying Control Adapters in SharePoint	sharepoint
Getting all the webpages of a SPWeb and subwebs that have a field with a value in Sharepoint?	sharepoint
SharePoint: How do I create a new list from a list template?	sharepoint
"What is the ""Task group"" field in a SharePoint Task list for?"	sharepoint
Customize accessdenied.aspx in Sharepoint	sharepoint
"Why does my web part throw an error about ""NT Authority/Anonymous User""?"	sharepoint
How to deploy Sharepoint publishing site with multiple sites	sharepoint
How to find the error detail on Sharepoint Services 3?	sharepoint
Guidance on creating non conflicting workflows	sharepoint
string;# in dropdownlist	sharepoint
BDC Web Part connection Interface error.	sharepoint
SharePoint Web Service Credentials	sharepoint
Best project format for VS2005 + SharePoint deployment?	sharepoint
MOSS Web Solution Package breaks when moved	sharepoint
Explorer view on a non-SharePoint page	sharepoint
SharePoint Integration for Single-sign On	sharepoint
Registering an event handler for a single list	sharepoint
Exception error message with incorrect line number	sharepoint
Sharepoint Code Generation Tool	sharepoint
"SharePoint Discussion Baord ""Last updated"" field is not updated any more."	sharepoint
SharePoint survey question ordering	sharepoint
Migrating a SharePoint Designer Workflow into Visual Studio Workflow	sharepoint
sharepoint web services in subwebs	sharepoint
Control size of report Using Report Viewer for SSRS in WSS	sharepoint
Moss 2007 (Microsoft Sharepoint office server 2007)	sharepoint
BDC Paging	sharepoint
Schedule an appointent from a SharePoint workflow	sharepoint
connecting web parts in sharepoint	sharepoint
Setting document library permissions in WSS 2.0	sharepoint
DataView component in SPD attaches needless strings to field values.	sharepoint
SharePoint: Temporary switching PageLayout of PublishingPage in HttpModule fails	sharepoint
Sharepoint 2007 maintenance and staging	sharepoint
How to SSL enable SharePoint	sharepoint
Hyperlinks In Sharepoint Webpart	sharepoint
best of sharepoint	sharepoint
Sharepoint ItemStyle.xsl for CQWP using images from a content type	sharepoint
Upload files to Sharepoint document libraries via FTP	sharepoint
xslt hyperlink, seperate the url and descption	sharepoint
Wrapping text inside a bound field in SPGridView	sharepoint
How to detect the item restore on a ItemAdded() event on SharePoint	sharepoint
display an image pulled from sharepoint using xslt	sharepoint
CAML to HTML	sharepoint
Use an XML File with a Feature	sharepoint
Sharepoint task list doesn't send email on item creation	sharepoint
Sharepoint 2007 document management	sharepoint
SharePoint publishing site email encoding/decoding	sharepoint
How do I check if a Sharepoint Document Library has the Require Approval flag set, using the Sharepoint API ?	sharepoint
Customizing pages view in Sharepoint	sharepoint
How do modify the look and feel of a Sharepoint site?	sharepoint
Optimizing Sharepoint Search Crawling	sharepoint
How do you disable a SharePoint webpart temporarily?	sharepoint
SharePoint and Office Open XML interaction question	sharepoint
Which are the best forums about Sharepoint 2007?	sharepoint
Microsft Enterprise Search - FAST	sharepoint
How do I convert Elevated Privilege code from C# to VB.Net for use with SharePoint?	sharepoint
What are some good resources on integrating web apps with SharePoint?	sharepoint
Automatic .aspx Publising in SharePoint	sharepoint
[SharePoint] Publishing HTML Field Control Converts Relative URL to Absolute URL	sharepoint
Viewing a MOSS 2007 page as another user would see it - without logging in as that user	sharepoint
Programmatically creating a MOSS publishing page	sharepoint
Creating a Sharepoint solution from a site (including workflows and custom webparts)	sharepoint
How can you make your custom property of a webpart in SharePoint 2007, sort to the top of the property pane?	sharepoint
Can I programaticaly replace one webpart with another in Sharepoint?	sharepoint
Accessing a remote file with a SharePoint Web Part	sharepoint
Getting files and their version numbers from sharepoint	sharepoint
Is there any good replacement for SharePoint Designer?	sharepoint
Hiding some user profiles temporary from search	sharepoint
Where are SharePoint resources strings located.	sharepoint
Possible to load a web part inside another?	sharepoint
Delete a Web that doesn't exist.	sharepoint
How to programmatically modify content in a SharePoint Web Part?	sharepoint
SharePoint OOTB Workflow Problem	sharepoint
User gets a 403 error (user has Full Control permission)	sharepoint
Uable to access sharepoint site	sharepoint
Extending the Content Query WebPart	sharepoint
How do I upload a document to SharePoint with Java?	sharepoint
Saving to SharePoint via WebDAV redirector. Getting new object ID and losing version history	sharepoint
Versioning by default in SharePoint	sharepoint
Display SharePoint lookup field on publishing website	sharepoint
Creating a development environment for SharePoint.	sharepoint
SharePoint Table of Contents Web Part and export/import	sharepoint
Get parent web not top level	sharepoint
SharePoint: What is the max size of the multi line text field? Can I set it?	sharepoint
Evaluating Sharepoint vs ASP.NET as a development platform	sharepoint
SharePoint Deployment Failure Using VS2008 Command Line	sharepoint
Anonymous SharePoint Users and people search core results web part	sharepoint
Sharepoint custom user and document library specific properties	sharepoint
Migrating MOSS 2007 from SQL 2000 to SQL 2005	sharepoint
Sharepoint refine results control only uses the current pages values.	sharepoint
How can you work out the ID of a users MySite	sharepoint
Best practice with SharePoint feature deactivation	sharepoint
Placing a Sharepoint Site under version control	sharepoint
Auto number column in SharePoint list	sharepoint
SharePoint setup best practices with ISA	sharepoint
Howto get SharePoint version using object model	sharepoint
How do I programatically set the SharePoint's site collections Search Center property?	sharepoint
how to localise a sharepoint site for different languages	sharepoint
How to upgrade a long running SharePoint Workflow already in production	sharepoint
Which CSS framework causes the least interference with SharePoint?	sharepoint
ServerContext.Current is null	sharepoint
SharePoint: Can I see the content of a document in the ItemAdding() event handler?	sharepoint
Sharepoint: Person column in custom list	sharepoint
How to create a custom document library in SharePoint?	sharepoint
Utilizing Sharepoint workflow functionality	sharepoint
Is Sharepoint the right platform for large ERP applications?	sharepoint
SharePoint Web Parts	sharepoint
Has anyone here worked on KOFAX-SharePoint 2007 integration?	sharepoint
Complex form design in Sharepoint	sharepoint
Get Max Date Using CAML Query From alist	sharepoint
Deploying a Custom Field Types to the bin directory	sharepoint
CAML Query not ordering properly	sharepoint
How to migrate a 3rd party web part from SharePoint 2 (2003) to SharePoint 3 (2007)	sharepoint
Sharepoint: SQL to find all documents created/edited by a user	sharepoint
Dated reminders in sharepoint calendars	sharepoint
SharePoint - simplest feature config to register a server control?	sharepoint
Multiple copies of a Sharepoint list view	sharepoint
How do I remove items from the Site Actions menu in SharePoint?	sharepoint
Make it impossible for users to remove web parts/zones?	sharepoint
how to deploy web.config modifications in a Sharepoint web application?	sharepoint
How can I fill in a Sharepoint List edit form offline using Windows Mobile 5.0 Quickly?	sharepoint
Sharepoint Lists.asmx: The request failed with an empty response.	sharepoint
Is it possible to have a custom webpart listen to default SharePoint search box?	sharepoint
Getting the NT-ID of a user in SharePoint	sharepoint
How is skill building for Sharepoint different from ASP.NET?	sharepoint
How to duplicate a virtual PC with SharePoint, K2 and domain controller	sharepoint
"SharePoint: ""Failed to extract the cab file in the solution"""	sharepoint
Firing a SharePoint Workflow by updating a list item through List Webservice	sharepoint
PortalSiteMapProvider	sharepoint
How to speed up sharepoint development in Virtual PC?	sharepoint
How do you deploy your common SharePoint library	sharepoint
Open Source SharePoint?	sharepoint
SharePoint Designer Workflow: Unruly 'Collect User Data' Action	sharepoint
Check permission on item in list	sharepoint
"SharePoint List Error: ""Value does not fall within the expected range"""	sharepoint
How to get in CAML (Sharepoint 2007)  the same results as SPNavigation.QuickLaunch?	sharepoint
How to alter sharepoint workflow task status?	sharepoint
WSS Change Page Layout	sharepoint
Sharepoint/WSS: helping writing xpath conditional expression	sharepoint
Sharing Data Across Sharepoint Sites - Roll Up or Pull Down?	sharepoint
Silverlight WebPart in SharePoint	sharepoint
Sharepoint: Is it possible to make subgroups in top navigation menu?	sharepoint
Can MOSS 2007 integrate with multiple LDAP/AD stores?	sharepoint
Updating WebPart Properties using RunWithElevatedPrivileges in MOSS 2007	sharepoint
Adding fields to the List Forms - Sharepoint	sharepoint
mrdivide function in Matlab- what is it doing and how to do it in Python?	matlab
Solve ODE without nested functions	matlab
Looking for an alternative matlab editor.	matlab
Matlab - problem with creating SQL query	matlab
what advantages MATLAB has over SCILAB and vice versa ?	matlab
What does fopen('text.txt', 'wt') mean in MATLAB?	matlab
annotation in matlab plot	matlab
Is there any way to silence the 'hold' function in Matlab	matlab
making function from symbolic expression	matlab
MATLAB: element-wise array replication according to a count	matlab
How to make a Simple FIR Filter using Matlab?	matlab
Turning y axis upside down in MATLAB	matlab
Running Multiple Versions of MATLAB	matlab
reading password protected excel file using matlab	matlab
Saving settings in matlab	matlab
matlab:comparing all elements in three arrays	matlab
Can I use Matrix Vision frame grabbers with Matlab?	matlab
Purposefully Slow Function	matlab
Matlab matrix translation and rotation multiple times	matlab
MATLAB: how to locate the nth appeared number in a loop?	matlab
Statistics toolbox in Matlab	matlab
vectorizing loops in Matlab - performance issues	matlab
How to open DBase files (.DBF) in Matlab?	matlab
Matlab/octave count number of operations	matlab
Why is caching answers taking LONGER in MATLAB?	matlab
how to see the code fo a matlab mex file	matlab
How to document object-oriented MATLAB code?	matlab
Fudge Factor in Matlab	matlab
Can I distribute my MATLAB program as open source?	matlab
Why the valid looking statement gives error in MATLAB?	matlab
What's the best way to iterate through elements of a matrix in Matlab?	matlab
How to graythresh a indexed image in matlab?	matlab
Matlab postpones disp calls when doing demanding calculations why is that?	matlab
Matlab - binary vector with high concentration of 1s (or 0s)	matlab
matlab 2009 creating symbol	matlab
Whta is the shortest way to write this in matlab ?	matlab
matlab fxn: find contiguous regions and return bounds in struct array	matlab
Matlab- select data from a 3d plot	matlab
how do you do symbolic differentiation on function handle?	matlab
Using imtophat in Matlab	matlab
Loopless  function calls on vector/matrix members in Matlab/Octave	matlab
can matlab catch signals from linux? SIGIO	matlab
how to find remaining nodes in following code which are not participating in making edges with each other?	matlab
When not to vectorize matlab?	matlab
Plot overlaps in matlab	matlab
Cell Array appending in Matlab.	matlab
MATLAB: Assign multiple colors to text in legend	matlab
Too many input arguments Matlab	matlab
Automatically plot different colored lines in MATLAB	matlab
How to change Matlab program for solving equation with finite element method?	matlab
matlab som clustering help needed	matlab
Read and write from/to a binary file in Matlab	matlab
Different right and left axes in a MATLAB plot?	matlab
Strange classes passed from matlab to java	matlab
Load any file type  into matlab	matlab
MATLAB - Delete elements of binary files without loading entire file	matlab
Plotting a grouped 2 dimensional vevtor in MATLAB	matlab
Get the indices of the n largest elements in a matrix	matlab
Reading images from file in MATLAB	matlab
Splitting data into trainning/testing datasets in MATLAB?	matlab
Is it possible in matlab to explicitly format the output numbers ?	matlab
function handle in MATLAB	matlab
A think on sum(X, 1)	matlab
MATLAB error while evaluating uicontrol Callback	matlab
safe, fast CFLAGS for mex functions in matlab	matlab
What are the 3 dimensions of a RHB image in MatLab?	matlab
Binning in matlab	matlab
How to convert Matlab output into an array?	matlab
How to get real Integer Overflows in Matlab/Octave	matlab
running old mex file on new matlab releases	matlab
Matlab copy constructor	matlab
Import & modify data in Matlab	matlab
Help in optimizing a for loop in matlab	matlab
Am I using histc wrong, or it this matlab's fault?	matlab
Out-of-memory algorithms for addressing large arrays	matlab
What's the difference between [A,B] and [A;B] in MatLab?	matlab
How to select which Matlab version to start from shell or Matlab startup?	matlab
Matlab multiple graph types inside one graph	matlab
matlab and function	matlab
How to plot lines between all points in vector in Matlab?	matlab
how to create a very large matrix using matlab	matlab
How to read till end of file in MATLAB?	matlab
read data into matlab from textfile	matlab
Call stack in compiled matlab	matlab
matlab: vectorized manipulation of cell array	matlab
Graphing special functions in Matlab (2D Bessel)	matlab
Infrared image processing in Matlab	matlab
Changing multiple .fig files in Matlab systematically	matlab
Matlab compiler runtime library	matlab
Snippets in matlab editor	matlab
Fastest way to import CSV files in MATLAB	matlab
Chop out parts of a square matrix in Matlab	matlab
Differences between matlab and comsol script?	matlab
Matlab - building an array while looping	matlab
Matlab matrix replacement assignment gives error	matlab
How to make a basic line plot in MATLAB?	matlab
using load instead of other I/O command	matlab
"MATLAB ""C"" DLL Errors"	matlab
.TXT FILES IN MATLAB	matlab
Parallel Matalb and logging	matlab
How to recognize overflow bugs in Matlab?	matlab
How to get a beautiful color scale on (semi-)logarithmic 3d plots on Matlab?	matlab
Texture mapping in MATLAB	matlab
how to use summation in matlab???	matlab
hoe to draw concentric circles in an image in matlab? Please help me	matlab
Connect points and compute area	matlab
How do I emulate 'include' behaviour in Matlab?	matlab
"Creating ""holey"" median filter in Matlab"	matlab
Extending a sequence statistically in MATLAB	matlab
spike in my inverse fourier transform.	matlab
Optimizing extraction of data from a Matlab matrix	matlab
modem.oqpskmod for BER	matlab
Matlab: How can I change the following program	matlab
How to do with this for fzero loop?	matlab
Can't compare the norm of a vector to 1 in matlab	matlab
Reading directories in matlab	matlab
3D plotting in Matlab	matlab
MATLAB Heart Curve	matlab
Matlab - add a plot to a hist	matlab
Problem using find function in Matlab	matlab
Matlab get file size	matlab
Replace empty cells with logical 0's before cell2mat in MATLAB	matlab
How do I go from 1.4795e+004 to 14795.00 ??	matlab
Matlab - plot multiple data sets on a scatter plot	matlab
Matlab GUI: How to Save the Results of Functions (states of application)	matlab
How can I tell if a rectangular matrix has duplicate rows in Matlab?	matlab
[Matlab] Storing Results of a Operation in a Matrix	matlab
MATLAB: vectorized array creation from a list of start/end indices	matlab
how to sketch a polygon in a matrix or binary image in order to use image processing functions?	matlab
How to optimize Matlab loops?	matlab
Break Polyhedron into Tetrahedron	matlab
Vectorizing for loops in Matlab	matlab
set intervals for plotting in matlab	matlab
How do I call Matlab in a script on Windows?	matlab
High speed udp receiver in matlab	matlab
How to implement such an effect using matlab?	matlab
How to plot a 3D plot in MATLAB?	matlab
what algorithm good for image matching?	matlab
Setting the variables of Solve in MATLAB	matlab
Plotting in Matlab	matlab
What's the correct syntax for applying a function to sub elements of a matrix without using a loop?	matlab
MATLAB: How do I get 3D coordiantes from a user-click?	matlab
Why is simulink data type conversion block altering the data when it should be typecasting?	matlab
Writing Java code in Matlab?	matlab
Call c++ code from MATLAB	matlab
matlab quickie: test if text file is empty	matlab
Implementing custom Matlab functions in Simulink	matlab
MATLAB: what's the most elegant way to delete known element in matrix?	matlab
how would i pick one node randomly from n no. of nodes,i have n random no. of nodes with x and y co-ordinates .(IN MATLAB)	matlab
Removing an array dimension where the elements sum to zero	matlab
Haskell equivalent of C's __LINE__	haskell
Haskell: parsing PDF	haskell
What is GHCi's default implementation of MonadError?	haskell
How to learn Haskell	haskell
string interpolation in haskell	haskell
Could someone explain these Haskell functions to me?	haskell
Comparing wildcards for equality in Haskell..?	haskell
Unwrapping datatypes in Haskell without extraneous code	haskell
[Haskell] Odd values when enumerating a list	haskell
Haskell - Redefining (hiding) arithmetic operators	haskell
Implications of foldr vs. foldl (or foldl')	haskell
Are all Haskell functors endofunctors?	haskell
"In Haskell, what does it mean if a binding ""shadows an existing binding""?"	haskell
What are some good intermediate problems and projects for learning Haskell?	haskell
haskel parsec term seperator question	haskell
Differences Between Hugs, Yhc and GHCi	haskell
Is there a built-in Haskell equivalent for C++'s std::bind2nd?	haskell
Tips for more elegant code with monads?	haskell
Guarded Equations in Haskell	haskell
Why does this first Haskell function FAIL to handle infinite lists, while this second snippet SUCCEEDS with infinite lists?	haskell
problems with Haskell's Number Types	haskell
Casting an mmapped ByteString to other types?	haskell
Tracking down errors in Haskell	haskell
Constraining the returntype to a Context	haskell
how can i evaluate an expression?	haskell
haskell, chaining filters	haskell
Creating a Haskell Empty Set	haskell
What does the : infix operator do in Haskell?	haskell
How do I get the Haskell Platform's ghc-pkg to work on MAC OSX	haskell
Why does this Haskell code work successfully with infinite lists?	haskell
Remove elements by index in haskell	haskell
"Operating on a return from a Maybe that contains ""Just"""	haskell
Haskell - Parsec Parsing <p> element	haskell
Haskell sort funtion	haskell
Simple Haskell graphics library?	haskell
Installing a Haskell package from Hackage through Cabal gets stuck at dependency resolution	haskell
What is Stream Fusion	haskell
Haskell IO with Numbers	haskell
How do i convert String to Integer/Float in Haskell	haskell
Predicate Logic in Haskell	haskell
Haskell: OpenGL, how to prevent immediate window closing	haskell
a function isn't loading	haskell
Haskell: recursion with array arguments	haskell
How does one declare an abstract data container type in Haskell?	haskell
Is this a correct way of writing the Haskell foldr function?	haskell
renaming current module	haskell
run wsHaskell on other machine	haskell
Haskell Error: Couldn't match expected type `Integer' against inferred type `Int'	haskell
Haskell function composition (forward pipe) - why does this work?	haskell
Adding deriving(Data) to standard types	haskell
Invoke Haskell function with heterogeneous arguments?	haskell
"using haskell for ""business applications"""	haskell
New to functional programming	haskell
Understanding Haskell's filter	haskell
"How to apply two functions onto the same string without using "">>"""	haskell
Jquery like selector in Haskell	haskell
Haskel Hello world, exclipse IDE	haskell
Haskell FFI: Calling FunPtrs	haskell
How do I specify types for Haskell's set builder notation ?	haskell
Why does this Haskell statement not evaluate lazily?	haskell
Haskell Input & Passing Values to Functions	haskell
GHC + wxHaskell on Windows	haskell
Finding index of element in a list in Haskell	haskell
Haskell and Quadratics	haskell
Testing QuickCheck properties against multiple types?	haskell
"Haskell equivalent of Python's ""Construct"""	haskell
How do you solve this Haskell problem using higher order functions?	haskell
In Haskell, how can you sort a list of infinite lists of strings?	haskell
Haskell & Oracle	haskell
unique elements in a haskell list	haskell
What is the C# equivalent of map function in Haskell	haskell
Learning Haskell: String manipulation question	haskell
Haskell: Why is it saying my function type is off?	haskell
Concatenating a list of numbers into one integer in haskell	haskell
Multiplying numbers on horizontal, vertial, and diagonal lines	haskell
Fully parenthesizer for Haskell	haskell
haskell function application	haskell
Haskell: Writing text files and parsing them back to original format	haskell
Really dumb question about haskell	haskell
What do you do when you feel you need a variatic list comprehension?	haskell
Haskell type error: Could not deduce (Show a) arising from a use of `show' from the context (Num a)	haskell
Erlang's term_to_binary in Haskell?	haskell
implement zip using foldr	haskell
Haskell audio output on OS X?	haskell
Primitive recursion	haskell
How do you combine filter conditions	haskell
Haskell pair and unpair functions	haskell
Why it does not work?	haskell
Haskell: print TextEncoding	haskell
is cabal-install supposed to act this way?	haskell
Point-free in Haskell	haskell
Haskell: monadic takeWhile?	haskell
Example of how to parse exiftool JSON output in Haskell	haskell
What does the >> symbol mean in Haskell.	haskell
Using items in a list as arguments	haskell
Haskell Sample Projects	haskell
haskell list to tuple	haskell
How to split up a file into modules in Haskell?	haskell
Haskell Tuple Size Limit	haskell
Can Haskell's monads be thought of as using and returning a hidden state parameter?	haskell
Haskell's liftIO's litter functions of type ErrorT String IO ()	haskell
Is there a quick-starting Haskell interpreter suitable for scripting?	haskell
What uses have you found for higher-rank types in Haskell?	haskell
Is Haskell, truly pure (is any language that deals with input and output outside the system)?	haskell
How do I read or write GTK TreeStores from/to files?	haskell
Visual Haskell 2008/2010	haskell
Haskell FFI: ForeignPtr seems not to get freed	haskell
Automatic migratiion between different Persistent backends	haskell
Can 2 or more equations defining a function in Haskell share the same where / let block?	haskell
Summation notation in Haskell	haskell
What exactly does TypeSynonymInstances do?	haskell
How to match rigid types in a type class instance?	haskell
absolute values in Haskell	haskell
In Haskell, is there a built-in function that creates a list of one element?	haskell
Concurrent DB connection pool in Haskell	haskell
patter matching for custom read function	haskell
Haskell recursive problem, tiny parser. Negation of Expr and let expressions	haskell
How to extract terms of specific data constructor from a list in Haskell	haskell
Integrating Haskell in non-functional projects	haskell
Haskell doubt: how to transform a Matrix represented as: [String] to a Matrix Represented as [[Int]] ?	haskell
Why is Haskell throwing a 'cannot construct infinite type' error?	haskell
How long does it take to create 1 million threads in Haskell?	haskell
Does functional programming mandate new naming conventions?	haskell
Haskell: convert unicode integer to actual unicode character	haskell
Printing a result during a recursion in haskell	haskell
"Is it recommended to always have exhaustive pattern matches in Haskell, even for ""impossible"" cases?"	haskell
Evaluating parsed expression in Haskell	haskell
Why this is not throwing any type error?	haskell
Function application: Why is $ used here?	haskell
Haskell Applicative instance for ErrorT?	haskell
Getting Kind mis-match error when trying to use existential quantification	haskell
Implicit type parameters in Haskell class definition?	haskell
Convert haskell Int with leading zero to String	haskell
List of GHC extensions	haskell
With Haskell, how do I process large volumes of XML?	haskell
Haskell Build Automation	haskell
Why isn't my IO executed in order?	haskell
Updating List Elements, Haskell	haskell
How can I easily see the output from a Template Haskell statement?	haskell
map versus mapM behavior	haskell
Which versions of packages can my Haskell package depend upon?	haskell
ORM tools for Haskell	haskell
What are your favorite programming-related academic papers?	haskell
on GHC extensions	haskell
Why does GHC infer type of `IO b` for an application of `hSetBuffering`?	haskell
When should I use $ (and can it always be replaced with parentheses)?	haskell
Finding if two numbers have the same digit and then remove them from in the original number in Haskell	haskell
problem with Double and Rational Number	haskell
"Understanding the type error: ""expected signature Int*Int->Int but got Int*Int->Int"""	haskell
Good Haskell coding standards	haskell
Wordpress on Localhost. Reset site to beginning?	wordpress
Wordpress: wp_get_attachment_thumb_url	wordpress
wordpress wp_get_archives output change with preg_replace	wordpress
Creating relationships between posts in WordPress	wordpress
Wrapping Current Category Text with Span in Wordpress	wordpress
WordPress E-Commerce Plugins	wordpress
Using SVN in Windows (Wordpress plugin-repository)?	wordpress
P tag is not displayed in html editor for Wordpress	wordpress
read more link in post is not working wordpress	wordpress
Parent category as a mainmenu and sub category as a submenu in wordpress	wordpress
Asynchronous UpdatePanel within WordPress Post	wordpress
Wordpress dynamic reply to comment not working	wordpress
How to change tinyMCE editor's button's default tag output in wordpress?	wordpress
What is your favourite WordPress theme framework?	wordpress
Using the php substr on the_permalink() in WordPress	wordpress
Making WP Templates	wordpress
How can I get the WordPress language_attributes function to return valid XHTML 1.1?	wordpress
JQuery Conflict with Lightbox2 WP Plug-in and Content Scroll	wordpress
Wordpress - image.php - if no image redirect to home	wordpress
Is there a way to stop WYSISYG editor in wordpress from trimming out certain tags?	wordpress
Wordpress blog date function	wordpress
Link to external URL in post title of RSS feed in WordPress.	wordpress
Comment Author Link on Wordpress	wordpress
WordPress Database	wordpress
Wordpress Database Fatal error	wordpress
Why the comment's id are continues?	wordpress
Wordpress problem language	wordpress
Get the Title of all posts	wordpress
WordPress widget (or sidebar) hooks	wordpress
Why doesn't jQuery Tablesorter Plugin work on this Wordpress page?	wordpress
I need a reccomendation for a wordpress Newsletter/Mailing list plugin	wordpress
how to prevent hacking of a WP site	wordpress
"How to get a Wordpress widget to ""remember"" values."	wordpress
Wordpress: Can  404.php page send values to header.php?	wordpress
insert in the head tag after wp_head	wordpress
What is your workflow for creating websites based on WordPress?	wordpress
I changed the permalink structure in my Wordpress blog. How can I redirect to a more robust URL structure??	wordpress
Wordpress: Editing pages with another editor.	wordpress
wordpress plugin encoding not working	wordpress
Wordpress MU themes and Plugins	wordpress
How can I determine a first-time hit in Wordpress?	wordpress
Wordpress: How do I get the current name of my page	wordpress
Why does my wordpress 404 page appear blank?	wordpress
Can you add a big flash banner to the top of a Wordpress blog?	wordpress
Can you display data from a database in a WordPress blog post?	wordpress
Wordpress URL routing problem	wordpress
Modify Latest Blog Posts in WordPress	wordpress
IN Wordpress, .php files within the theme folder do not run, but return 404 error	wordpress
Sharing authentication between ASP.NET and WordPress	wordpress
"is there a wordpress ""lightbox"" type of  plugin that works on the iPhone  ??"	wordpress
Inserting a link to another post in Wordpress	wordpress
Active link state help WORDPRESS	wordpress
WordPress: Image In Every Post	wordpress
Future posting with dateCreated in Wordpress via XMLRPC in Ruby	wordpress
using the search box causes get_posts() malfunction	wordpress
Redirect after plugin activation	wordpress
wordpress shortcode for wp_list_categories()	wordpress
Is it possible to change themes per category in wordpress?	wordpress
wp_redirect acting weird. requires die() afterward?	wordpress
Wordpress get_post_meta	wordpress
How to post Source Code inside a Wordpress blog post	wordpress
WordPress 404 Errors	wordpress
Wordpress page grouping	wordpress
Wordpress htaccess in root overriding htaccess in subdomain. Subdomain app not working now.	wordpress
Limit Ammount Of Widgets In Wordpress	wordpress
Submenus in Wordpress	wordpress
Wrap stray text in <p> tags	wordpress
Is there a way to programatically enable a widget from a plugin in WordPress?	wordpress
How do I use underscore in a wordpress permalink	wordpress
Is there an open source Wordpress plug-in to implement Facebook/Twitter/OpenID/... authentication?	wordpress
How can I safely port my wordpress blog to localhost?	wordpress
i inserted a search field into wordpress and it wont show.	wordpress
Wordpress make own queries	wordpress
Debug irrelevant Wordpress search results	wordpress
Ad targeting for individual posts in Wordpress	wordpress
Wordpress Hooks	wordpress
"Why does the ""choose files"" button not work in Wordpress 2.5 when trying to upload photos?"	wordpress
wordpressL How to array the child categories without any html tags?	wordpress
"Wordpress Install: ""ERROR: you must provide an e-mail address."""	wordpress
How do I adjust the Wordpress URL handling to ignore certain directories?	wordpress
Charging for subscriptions/downloads with Wordpress	wordpress
Limiting the list of archives in wordpress based on date	wordpress
PHP wordpress style related posts	wordpress
Associating an image with a post in WordPress	wordpress
Possible to change location of the login landing?	wordpress
what are  current_user_can () function parameters ?	wordpress
"is there a way to use a different URL structure for ""static"" pages in WordPress 2.9?"	wordpress
WordPress get count of posts without using get_posts()?	wordpress
Can two different wordpress blogs on the same server use a common theme folder?	wordpress
bit.ly links in wordpress twitter status updates leads to 404	wordpress
WordPress url error on IIS 7	wordpress
Wordpress dashboard	wordpress
Custom post metabox with upload file button	wordpress
Wordpress post sync / publish to production	wordpress
Wordpress Category Link get_category_link(id)	wordpress
"How to customize wordpress ""comment error"" page"	wordpress
Help with wordpress and adding jquery please	wordpress
Multiple loop working, function inside isn't	wordpress
Problem with Japanese/International Characters with IIS7 URL Rewrite	wordpress
Wordpress 2.9 theme options admin page with image upload	wordpress
how templates work on wordpress?	wordpress
List categories with checkbox in Wordpress Options?	wordpress
Add URLs to list of urls to send pingbacks to in Wordpress	wordpress
How can I embed a WordPress blog into another site?	wordpress
What is the proper way to wrap this php loop around the javascript	wordpress
WordPress  Menu with Superslide show	wordpress
Wordpress Control Panel	wordpress
How do you add html/styling to the author profile on wordpress?	wordpress
Using Wordpress as more than just a blog?	wordpress
Creating a virtual, data-driven section of a Wordpress-powered site	wordpress
show last 5 posts that have <!--more-->	wordpress
How to set up a website with WordPress ?	wordpress
How to make blog network like SmashingMagazine	wordpress
How can I loop through posts as well as child pages to display them all by date in Wordpress 2.9	wordpress
Find and Store (Regex, PHP)	wordpress
Display Posts from a category in Wordpress?	wordpress
WordPress - producing a list of posts filtered by tag and then category	wordpress
How to back up wordpress site to be restored after a clean installation	wordpress
How can I delay one feed in wordpress but not the others?	wordpress
Wordpress Multiple Developer Setup	wordpress
Filtering Custom Fields in Wordpress Plugin Dev	wordpress
What is the best minifying plugin or tool for wordpress based sites	wordpress
WordPress: don't show 404 when no posts exist	wordpress
wordpress get_categories() issue	wordpress
How do I create a custom wordpress page?	wordpress
Wordpress: add a custom field option that's available to all posts	wordpress
Good Syntax Highlighter For Self-Hosted WordPress Blog	wordpress
Show Attached Image to Post on Wordpress	wordpress
Arabic Digits in Wordpress	wordpress
Wordpress: using a test theme only for a specific user	wordpress
What is my error with my Feed in Wordpress	wordpress
wordpress plug-in or anything that will allow us to edit the meta tags for each individual post?	wordpress
How do I create a custom loop in wordpress that excludes categories listed in theme options	wordpress
Facebook-WordPress comment/feedabck integration	wordpress
Displaying code snippets in wordpress.	wordpress
navXT breadcrumbs plugin for wordpress, hide post title	wordpress
Need to add selector to child UL in WordPress menu	wordpress
Wordpress Blog RSS Feed Problems	wordpress
wordpress plugin, access $wpdb on non visible page	wordpress
Wordpress Roles > Allow Editors to Edit Themes?	wordpress
Wordpress permalinks problem	wordpress
Addiing captions above images in wordpress	wordpress
PHP Error handling in WordPress plugin	wordpress
How to make Wordpress plugin first plugin to be run?	wordpress
when blogging on wordpress. my blog destroys the template i created. how to  avoid that?	wordpress
Strategy in the design and coding of wordpress themes?	wordpress
Redirecting Wordpress's Login/Register page to a custom login/registration page	wordpress
Displaing list of categories and tags â€”Â Wordpress	wordpress
WordPress functions.php Problem	wordpress
Is it possible to register a user and submit a comment with one form with Wordpress?	wordpress
How to create the file browser in view for spring roo?	spring
Separation of Presentation and Business Tiers with Spring	spring
Which one of the java spring books to start?	spring
gwt+grail.. advantages and shortcomings..	spring
About Spring BeanFactory	spring
spring security integrate with facebook connect	spring
SessionFactory in Hibernate	spring
How can I package an extensible default Spring configuration in my framework?	spring
Spring beans, Lifecycle in a XmlWebApplicationContext (web context)	spring
Where do you define spring bean configuration files	spring
Whats wrong with my Url Mappings?	spring
Obtaining a Hibernate transaction within a Spring class	spring
Custom spring scopes ?	spring
Location of view.properties in my proyect spring mvc jasperreports	spring
Dependency Injection mechanism	spring
How do I set a dependency on Spring Web Services in my POM.xml	spring
Java Project Configuration	spring
on submit action	spring
Dependency Injection into your Singleton	spring
SpringFramework3.0: How to create interceptors that only apply to requests that map to certain controllers?	spring
Getting the caller to a Spring AOP Proxy	spring
Spring 2.5 Form validation - Dynamic data lost if validator is called?	spring
Spring AOP vs AspectJ	spring
How to use spring to resolve dependencies of an object created manually?	spring
SOAP and Spring	spring
How can I implement a redirect-after-post form with Spring's AnnotationMethodHandlerAdapter?	spring
Spring AOP Pointcut syntax for AND, OR and NOT	spring
spring & web service client - Fault Detail	spring
SPRING: How do you programmatically instantiate classes based on information passed from Flex UI	spring
caching spring/hibernate webapp	spring
Cannot migrate from spring 2.5 to spring 3.0	spring
Spring beans redefinition in unit test environment	spring
Howcan I get started with Spring Batch?	spring
"How to generate a dynamic ""in (...)"" sql list through Spring JdbcTemplate?"	spring
Generating simple crud applications in Spring based off existing database or hibernate configurations?	spring
Running spring program inside application server	spring
Getting LazyInitializationException when trying to integrate Hibernate and SpringMVC for a web app	spring
Using Resteasy with javassist?	spring
Spring introductions with dynamic implementation	spring
Creating multiple forms in one jsp file. ModelAttributes have to always be set?	spring
Two approaches of task distribution in a multi tier application	spring
do i need to worry about concurancy with tomcat spring beans	spring
spring multiple property file	spring
Executing a method from another class in java(and more)	spring
Bulk inserts with Spring / Hibernate	spring
Spring framework IDE - where to learn efficently?	spring
jdbcTemplate hangs on long update	spring
Exception in JEE application Email Notification Pattern	spring
how to add filterclass into applicationContext?	spring
Exception thrown after processing onSubmitAction	spring
Is it possible to bind a Spring Form to an Object using the constructor or by mapping multiple fields to a single value via a custom Editor?	spring
In Java/Spring, how do you setup the hashmap to append the query string?	spring
Wiring Twitter class of Twitter4j in Spring	spring
What is the different between spring 2.5.6 and spring 2.5.6.SEC01	spring
Spring Design By Contract: where to start?	spring
What happened to the Spring Modules project?	spring
Reading a list from a java .properties using Spring properties place holder	spring
How to batch delete using bulkUpdate	spring
System properties can't be resolved in Spring XML using Maven	spring
multiple security:custom-authentication-provider	spring
Best way to validate URL parameters in Spring MVC website?	spring
Spring MVC DefaultRequestToViewNameTranslator capitalization issue	spring
Spring Security Encypt MD5	spring
Dependency Injection problem with EntityManagerFactory + jpadaosupport	spring
ModelAttributes  not accessible on jsp (Spring MVC)	spring
Spring - best way to deal with binding to a list of beans in a simpleformcontroller	spring
How to modify beans defined in a spring container	spring
Short way of making many beans depend-on one bean	spring
Spring - StackOverflowError in Bean creation	spring
SpringIDE and eclipse galileo 3.5	spring
Extending spring's default component factory	spring
Integration Test with Spring: Cannot convert value of type error	spring
how do i check for errors in spring - security ?	spring
Spring Security 3.0- Customise basic http Authentication Dialog	spring
same bean id on different xml file, will it merge?	spring
My Spring AOP not working	spring
DefaultMessageListenerContainer not working with Websphere MQ	spring
Is it possible to use placeholder in context.xml	spring
How to externalize a Spring MessageSources bundle outside the WAR	spring
Can't make hibernate stop showing SQL using Spring JPA Vendor Adapter	spring
DWR + Spring + JPA Session Closed	spring
Exposing multiple objects with RMI in Spring	spring
Trying to setup externalizing properties in spring	spring
Apply dynamic properties to a bean at runtime	spring
Spring: Is there a simple non-web tutorial?	spring
multiple session factories, one connection?	spring
How to inject dependencies into HttpSessionListener, using Spring?	spring
Setting nested object to null when combobox has empty value	spring
How do I redirect to an ftp:// url with Spring Webflow?	spring
Get Spring Security intercept urls from database or properties	spring
Caching a resultset	spring
Spring + Hibernate bean declaration error	spring
Is there a transaction management for DAO in Spring framework?	spring
Accessing the JDBC ResultSet concurrently in Spring	spring
Embed XML configuration directly in Spring application context	spring
Spring Application Context Switch at Runtime	spring
Spring Webflow Best Practice	spring
ConstraintViolationException VS DataIntegrityViolationException	spring
Spring rejecting bean name, no URL paths specified	spring
how to integration test a DAO built with spring + iBatis	spring
FileSytemResources in Spring Framework	spring
JSR-303 dependency injection and Hibernate	spring
Spring scheduler shutdown error	spring
Java Execution Context Class Explain	spring
Spring Entity to use Service, possible design flaw, but still....	spring
incompatible types found: required: default enums in annotations	spring
Avoiding in-place pointcut expression in Spring AOP	spring
Is it possible to configure a Spring session scoped bean with attributes from the session?	spring
springsource tool suite (eclipse) tutorial?	spring
Spring - How to load a new hierarchical context?	spring
How do I use Spring's IdToEntityConverter to do my Entity Type Conversion during form binding?	spring
EntityManager merge/persist problem	spring
Downloading spring 3.0 with dependencies?	spring
Spring Datasource and Database Schema	spring
Spring validation errors not displayed	spring
How to know the line of a bug in a spring generated bean ?	spring
Spring configuration file cannot parse elements defined in my own schema	spring
Best way to Learn Spring Framework	spring
Spring @Transactional Annotation Best Practice	spring
Server side MVC +Client side MVC	spring
Spring freemarker bind - what is controller?	spring
How to google for spring 3.0 documentation?	spring
Dealing with SQLException with spring,hibernate  & Postgres	spring
How to wire Interdependent beans in Spring (Deferred property binding)?	spring
Problem with Spring @Configuration class	spring
Where to store database passwords in a spring application or use JNDI?	spring
XSD Client in Spring	spring
Spring using JNDI with Tomcat... why do I need a META-INF/context.xml in my project	spring
Auto-wiring a List using util schema gives NoSuchBeanDefinitionException	spring
Usage question: Spring AOP vs. AspectJ weaving	spring
How to XML configure Spring bean for constructor injection when bean has varargs constructor	spring
Spring ApplicationContext Bean Scope	spring
Circular Dependency and Spring-powered Event Queue	spring
How to correctly implement OpenSessionInView with Spring 3.0 and Hibernate 3 (in liferay portlets)?	spring
Spring WebContent Resources - Access outside ServletContext	spring
Spring: How to programmatically define FactoryBean	spring
In spring, what code is used to inject the value for the @PersistenceContext annotated variables?	spring
Pointcut not working with Spring AOP	spring
What do I need to offset the performance setback induced by use of the Spring framework?	spring
Spring Security UserDetails Best Practice	spring
Can I inject an interface subtype in Spring?	spring
Start app in a web flow	spring
SpringJUnit4ClassRunner initialize beans for each test?	spring
Should I use Spring or Guice for a Tomcat/Wicket/Hibernate project?	spring
Spring servlet mapping - no css or jsp!	spring
Database-sessions in Spring	spring
How can I check Spring Security for user authentication and get roles from Flex?	spring
spring and interfaces	spring
Spring, db and property file configuration.	spring
host/role dependent spring configuration	spring
magento database connectivity	magento
PCI compliance issues for Magento running on Bluehost	magento
"Magento - Add a checkbox to ""Edit Customer's Address"" formular"	magento
Can one host multiple store on Magento Community Edition?	magento
Affiliate programming in Magento	magento
How do I print all the queries in Magento?	magento
Magento - How can I move the Navigation Block to be in the right column?	magento
Magento Fatal Error: Call to member function getSku() on a non-object	magento
How can I clear Magento Cache when using a Memcached server	magento
Magento & vertnav extension	magento
Magento and unsetting a custom boolean attribute	magento
how magento parse url?	magento
Magento use own handle in widgets doesn't work	magento
Magento - Create new user returns SQLSTATE[HY000] [2002] Can't connect to local MySQL server through socket '/var/lib/mysql/mysql.sock' Help?	magento
Magento - create a fixed module	magento
indexing magento	magento
how to get a product's image in magento?	magento
10cent per product tax magento	magento
magento indexControllor.php url rewriting not working properly	magento
How to set custom grand total before checkout process in magento?	magento
installing Lingotip translate on Magento; php version conflict; would like to override	magento
How to select specific fields with aliases using joinTable or joinField in Magento	magento
Magento custom option import for products problem	magento
"Mass Update Magento Field to ""Use Default Value"""	magento
Magento: use various methos in 1 model	magento
Magento - Edit sidebar naviagtion on Customer's Account dashboard	magento
Magento Store - SQL Error	magento
Credit card processing between Magento & Oracle	magento
Magento: is there an API to mark an order as shipped?	magento
Magento, 1 db field not saved	magento
magento custom link and insertion of form data	magento
Magento - Programmatically added products don't show up	magento
Magento 1.4 extension development	magento
Ideas for Implementing Magento Order Approval process?	magento
changing navigation in magento dynamically	magento
FILTER BY ATTRIBUTE MAGENTO	magento
Magento: Adding a custom EAV attribute that autopopulates with its default value on entity creation.	magento
move magento attribute to tab	magento
Magento - Changes to Edit Account Information screen do not get reflected	magento
Magento paypal currency error	magento
Magento Custom Module database query	magento
i need help to integrate webgistix shipping method into magento	magento
In Magento, how can I preview a page before saving it?	magento
magento url rewrite	magento
Magento 1.4 Load By Category Not Working	magento
Magento rewrite headaches	magento
Magento and country codes for table rates	magento
Need Help with Magento Mini-Search	magento
Using catalog image as full background image in Magento	magento
Create guest order in the backend with magento	magento
Magento losing cart / add to cart failing	magento
Newsletter Signup on CMS page in Magento	magento
Fatal error: Call to a member function setActive() on a non-object	magento
How do I transfer a local Magento install onto my live server?	magento
SQLSTATE[42S02]: Base table or view not found:	magento
Why magento does not provide Guide or Manual for developers?	magento
Can't upload images with Magento 1.4 on Windows/IIS	magento
A  good magento shared  host	magento
Magento CMS page (or block) mass import	magento
Magento - Modify and have different set of fields and labels for cart and checkout screens	magento
customize the magento default search at front end	magento
[MAGENTO] Index page is way too slow, what can I do?	magento
is magento overkill for a one-man webshop?	magento
Magento migration to local environment	magento
How can i open popup window in magento admin panel?	magento
Magento: Including a module template into the checkout process	magento
How do you overide a class that is called by another class with parent::method	magento
Magento layout related basic Questions ?	magento
What Block Type for Left Column in Magento Theme?	magento
Google analtyics is showing hundreds of 404s resulting from a null url	magento
In Magento Layered Navigation, how do I get all items for active filters?	magento
Set Special Price Programatically In Magento	magento
Magento Store - Remove Block using Update XML	magento
Magento - Product prices with and without VAT change	magento
changing / maintaining regions in magento	magento
Can I use Magento without the sales features? Or am I better off with a scratch build?	magento
how do i hide /magento/ in my site's url?	magento
Magento Admin Custom Sales Report	magento
Magento - Paypal Express 404 Error	magento
Magento export product problem	magento
Is there an application that does two way sync of Magento and a billing software?	magento
Help with Magento Custom Module. Redirect to another module and return to checkout	magento
Set Tax Rate in Magento based on Discount / Coupon Code.	magento
Magento - Tag wishlist products in admin -> order	magento
What about the event before order save in onepage checkout in Magento 1.4?	magento
Weird Error In My system.log file Over and Over and Over	magento
Magento: After ordering configurable product, its canceled because its out of stock	magento
Creating Custom Options on a Product using the Magento API	magento
Magento Ajax - How to get only body part?	magento
Overridding a Shipping Method - What am I missing	magento
magento integration with erp and crm	magento
Magento custom attribute default value not showing in front end	magento
Magento: how to use Mage::getConfig()->setNode($path, $value) to change config variables during the session	magento
magento block injction via module.xml	magento
Magento - making a new getProductCollection() function	magento
Magento - Strange symbol in the invoice's PDF	magento
Retrieve attribute code	magento
How to change image on locale base in magento?	magento
Current user in Magento?	magento
Magento - Buy 2 items get % discount	magento
How do I get a full Magento session in an external script? (Specifically, Catalog Rules)	magento
How to replace gif logo with flash logo in magento?	magento
Error while adding Attribute in Magento 1.4.2	magento
Magento google checkout integration issue 404	magento
send form data as email in Magento	magento
getStoreCategories() returns nothing	magento
Magento doesn't save my catalog_product_set, what can I do?	magento
Authorize and then Capture programmatically using Authorize.Net in Magento	magento
Magento Ecommerce	magento
Magento get Last login	magento
Hide categories that have no products magento	magento
Magento install errors	magento
"How to have ""My Cart"" link outside of Top Links?"	magento
Show only current categoryâ€™s products in Product View	magento
Is it possible to export/import product categories in Magento?	magento
Magento - Layout and block	magento
Magento Paypal Express having issues with Downloadable Products	magento
Magento config XML for adding a controller action to a core admin controller	magento
How to get reviews success message in magento?	magento
in magento 1.3.2 which file is responsible forstoring the data of payment gateway options like Mastercard visa AMEX?	magento
How to translate product name and info in Magento	magento
Magento order tax information	magento
How to change category page layout in magento	magento
Testing sucess with shipping enabled vs disabled in Magento	magento
"Magento Complex Attribute: Value(s) = (Drop-Down item + Text Field input), and need an ""Add Another"" button."	magento
magento admin usernames	magento
How to delete / clear all product reviews in magento?	magento
What is the correct way to set up an observer in Magento?	magento
custom filter is not woring - Magento	magento
Customer session is different in different parts of a Magento website	magento
Displaying custom product attributes based on customer group (Magento)	magento
magento VS magento clone - cost of ownership	magento
Magento - showing review links & add-to-compare links on custom pages	magento
prototype - Replace & with &amp;	magento
Magento Ajax cart - the correct way	magento
Magento : How do i echo username	magento
product price Issue	magento
How can I use Tier Pricing with Configurable Products? (Magento 1.4+)	magento
fatal error Varien_Autoload not found	magento
Running Magento for multiple clients Single Installaton Vs Multuiple installation	magento
Transferring magento to MediaTemple	magento
Magento Bundled Product Restrictions	magento
Magento frontend and backend page looks different	magento
Preconfigured Magento Widgets	magento
Magento - Is it possible to feed IE6 a different template?	magento
AW Blog (Create Bookmarklet Feature)	magento
Do PHP 4.4.9 based applications run on PHP 5.2.0 flawlessly?	magento
creating magento groups needs reindexing	magento
Magento - Buy X Get Y Free - Realistically, Buy one get one free BOGOF	magento
Why can i not rewrite parent class?	magento
Is there a graceful way to stop svnserve -d	svn
Multi-domain Subversion Deployment on Media Temple DV	svn
Graphical representation of SVN branch/merge activity	svn
Best branching stragetgy when doing continuous integration?	svn
mod_dav_svn loading error on centos 5	svn
Using Git in a Company?	svn
What is a good book about SVN?	svn
"How do I undo ""svn switch"" on a subdirectory?"	svn
Common Types of Subversion Hooks	svn
How mature is PHP:SVN	svn
svn diff a specific line in a file	svn
How to list source versions using subversion	svn
How do I achive the below using svn ?	svn
"Can you ""ignore"" a file in Perforce?"	svn
How to run svn-populate-node-origins-index on Windows	svn
"How to write an automatic ""copy, check-out, change and check-in""-skript for svn"	svn
Implementing a Code Freeze with Subversion	svn
svn / subversion: Get ALL files on new check out, but then exclude certain files from update/check in	svn
Can svn:externals be used while ignoring externals for that URL?	svn
Alternative to binaries in Subversion	svn
SVN Watchlists?	svn
SVN branching and merging in a rapidly changing feature environment with a high-turnover	svn
How to configure svn in local server/LAN server	svn
SVN - Not a working copy error	svn
subversion merge a delete command	svn
Is there a tool for monitoring and annotating SVN checkins?	svn
How do I know which files in a directory arn't in my SVN repository?	svn
Always Commit the same file with SVN	svn
Is there any way to only update added files?	svn
How does git-svn behave with svn repositories that have changed layout?	svn
"Recovering from an unfortunate ""svn copy"""	svn
Subversion Berkeley DB broken, recovery failed.	svn
Subversion ignore classes directory after its been added (and linked to src directory)	svn
SVN plugins for Eclipse - Subclipse vs. Subversive	svn
Where can I find the file VisualSVNServerHooks.exe	svn
Subversion update externals to a date	svn
Providing a common interface to SVN and CVS	svn
How to reset svn-properties according to new SVN config?	svn
Moving to Subversion from SourceSafe	svn
How can I access a subversion repository using a local path in Windows?	svn
Managed Source Control Hosting and Continuous Integration with CVSDude and CruiseControl.net	svn
Advice on setting up a server to host source code and other documents...	svn
Free Online SVN repositories	svn
in-house projects: to stable release or not?	svn
subversion cherry picking	svn
TortoiseSVN Error	svn
What's the best way to persuade my employer to move from VSS to Subversion?	svn
How do I move tags in Subversion	svn
Presenting code on my personal website	svn
What is the optimal configuration for serving multiple projects with Subversion ?	svn
SVN externals sub folder changes not showing in view log (tortoise svn)	svn
How to set up a not-local svn-server?	svn
Using Revision Control  for home development	svn
How do I learn to use SVN effectively?	svn
svn switch --relocate not persisting	svn
In Subversion what are best practices to modifying historical files?	svn
svn repository path changed: how to re-bind my local folder to it?	svn
what is a pre-revprop-change hook in SVN and how do I create it?	svn
Add a file to subversion with special characters like '%' in the filename.	svn
Best way to migrate from VSS to Subversion?	svn
when updating a whole project's root, how to exclude svn externals from being updated?	svn
SVN Merge changes made on FTP into working copy	svn
SVN and Visual Foxpro Databases	svn
Upgrading to SVN 1.5	svn
What is the optimal way to organize shared .net assemblies in SVN?	svn
Svn organisation problem	svn
Change Revesion Number in Subversion, even if the File not change in the commit.	svn
How can you overcome the svn 'out of date' error?	svn
How do I fix this Subversion MKCOL error?	svn
Preventing DB password from being accidentally checked into public SVN	svn
Learning how to use Subversion	svn
Web SVN for Windows?	svn
Subversion for SourceSafe users	svn
SVN optimizations to keep large repositories responsive	svn
What to do when 'svn cleanup' fails?	svn
SVN workflow, LAMP	svn
Rar command - ignore certain folders	svn
Problems commiting file to SVN repository	svn
How do I get a list of files that have been added to the SVN since a certain date?	svn
How can I use FTP to update my website from a Subversion repository ?	svn
Opensourcing a starter web application	svn
Any tools to get code churn metrics for a Subversion repository?	svn
Subversion: error on checkout - Mac OS 10.5	svn
Subversion question: How can I use post-commit hooks to copy committed files to a web directory?	svn
SVN Error: Expected fs format between '1' and '3'; found format '4'	svn
Do I lose change information with svn move --force?	svn
"How do I avoid ""svn: Out of Date:"" problems?"	svn
Need good scheme/workflow for managing database objects using Subversion	svn
How to specify the repository in apache dav svn?	svn
SVN admin can create folders, but can't delete them	svn
Where to manage the most sensitive content you have under version control?	svn
Use local Git repository with a master Subversion repository.	svn
netbean subversion	svn
Recover empty SVN DB file	svn
Code Promotion: Build or Binary?	svn
Best setup for code promotion and feature branching in Subversion?	svn
List all files changed by a particular user in subversion	svn
Get revision number of a remote repository	svn
TSVNCache.exe is heating up my Mac	svn
Installing Svn 1.5.x on Debian Etch - Best approach?	svn
What's the best FREE collaborative platform for 2/3 programmers?	svn
Why does TortoiseSVN (1.5.3) try to merge 1-Head when I pull from trunk?	svn
Enable anonymous Access (svnserv)	svn
Standalone SVN client for Mac OS X	svn
SVN Merge help	svn
Import Dumped SVN Repo into Visual SVN	svn
How do you get the history of a file/folder property in SVN?	svn
SVN and binaries	svn
Best SVN Client Ignore Pattern for VB.NET Solutions?	svn
What is the maximum password length in Subversion?	svn
Subversion merging changes from a different repository	svn
Moving directories in subversion	svn
partial commits with subversion	svn
Is there a tool to read a subversion repository via .net?	svn
Undelete in SVN working copy	svn
is svn-merge backwards?	svn
Subversion Tagging and Security	svn
Rollbacking bad changes with svn in Eclipse	svn
How to quickly search a subversion repository?	svn
CruiseControl.net : Using SvnLabeller / SvnRevisionLabeller	svn
How can I use Beyond Compare 3 as the diff3-cmd for svn?	svn
Similar SVN Server software for OS X that's like Visual SVN	svn
? Structuring a Revision Control System (SVN)	svn
Why doesn't git-svn use the Subversion repositories UUID instead of its URL	svn
Using svn and .NET Winforms - Building Install Files Deletes _svn Folders	svn
Check for a subversion update	svn
SVN best-practives - working in a team	svn
How to get back a file my SVN client deleted?	svn
How do I import multiple branch-type directories into git-svn which aren't exclusive children of the same parent?	svn
Try to svn checkout, but get: svn: '.' is already a working copy for a different URL	svn
Is there any way to throttle the network bandwidth that an svn checkout does?	svn
SVN Remove File from Repository without deleting local copy.	svn
Script to backup svn repository to network share	svn
what is the best way to backup subversion repositories?	svn
Using Mercurial, is there an easy way to diff my working copy with the tip file in the default remote repository	svn
"""Phantom"" directories in an SVN repository"	svn
Getting a useful report from SVN - non-code files messing the stats up	svn
How do I tell Subversion to treat a file as a binary file?	svn
"Subversion ignoring ""--password"" and ""--username"" options"	svn
[SVN] Where did my committed file go?	svn
Sending SVN commits to an RSS feed	svn
Forbidding SVN commit lacking description	svn
Does anyone have experience with National Instruments CVI and source control?	svn
Switch from SVN to GIT for C# developments?	svn
Using svn:ignore to ignore everything but certain files.	svn
Subversion: prevent local modifications to one file from being committed?	svn
SVN Diff Export	svn
Getting specific revision via http with VisualSVN Server	svn
How do I make/apply a diff patch to this situation ?	svn
Subversion asks for incorrect user	svn
ScriptResource.axd requests return HTTP 302	ajax
How to manipulate ajax loaded content?	ajax
ajax login using httpRequest?	ajax
Ajax books and tutorial	ajax
go back to last state ajax pages?	ajax
Are AJAX sites crawlable by search engines?	ajax
What is exactly is Ajax request? Is it different from Servlet Request?	ajax
Cannot do response.redirect from page with Ajax controls	ajax
Rotating a Div Element in jQuery	ajax
corrupted ajax result	ajax
rails ajax update only once	ajax
My trigger doesn't work in updatepanel?	ajax
Ajax call completed event	ajax
Rails: submit (via AJAX) when drop-down option clicked	ajax
IE not updating display after callpback pane updates the DOM	ajax
Is there ANY way to suppress the browser's login prompt on 401 response when using XmlHttpRequest	ajax
"Is it possible to send custom headers with an XHR (""Ajax"" request)?"	ajax
Using Google Table inside jqueryui ajax tab	ajax
Problem with textbox inside updatepanel - not causing OnTextChanged event	ajax
AJAX refresh script	ajax
How do I get the AJAX top menu that StackOverlow has?	ajax
jQuery is adding servlet name twice to URL	ajax
AJAX Alert Box with visitor memory - any examples?	ajax
Is there an alternative of ajax that does not require polling without sever side modifications?	ajax
AJAX request status returns 0	ajax
Securing AJAX Requests via GUID	ajax
AJAX C# AutoCompleteExtender contextKey	ajax
ajax request to different host	ajax
AJAX - when user leaves page - good or bad practice/implementation?	ajax
update progress and it shows image while data is pulled from Database.  but need  to  block the  screen	ajax
Is it possible to integrate ajax toolkit into mvc appliocations?	ajax
Trouble with Ajax (creating a <select> dynamically..	ajax
php validation using jquery and ajax	ajax
Isn't AJAX on pageload a bad thing?	ajax
When is image within the updateprogress control sent to client in asp.net ???	ajax
what is encoding in Ajax?	ajax
Returning value from AJAX request in a global variable	ajax
Executing Javascript functions from an AJAX - HTML response.	ajax
Refire certain scripts after jQuery AJAX load.	ajax
A good way to send complex objects with ajax?	ajax
How to return javascript variable to Ajax?	ajax
how to send an object from one js file to another js file ?	ajax
Upload File Directly to S3 with Progress Bar	ajax
Javascript and AJAX, only works when using alert()	ajax
Accessing control, ajax, asp.net	ajax
Dealing with incremental server response in AJAX (in JavaScript)	ajax
Ajax won't get past readyState 1, why?	ajax
Whats the best way to implement an AJAX timeout?	ajax
asp.net ajax 4.0 with MVC -externalize templates	ajax
Dynamically replace html tags	ajax
Submit multiple value when using Ajax.Request and Starbox	ajax
Send asapMail without reloading page using ajax	ajax
Updating multiple DIVs via AJAX is inconsistent	ajax
How to get formcollection using ajax.actionlink	ajax
How to make all connected browsers reload initiated by a server-side event	ajax
Online dictionary - should I use AJAX for the search results?	ajax
Lock a button while an AJAX call.	ajax
AJAX browser-dependent limit on length of data sent? (SAJAX)	ajax
ajax architecture question	ajax
AJAX support in smart phones	ajax
AJAX PageRequestManagerParserErrorException error in asp.net page	ajax
Jquery , Ajax and Live Function issues....	ajax
"AJAX to do Real Time DB Polls like Twitter's ""Real Time Results"" in Coldfusion"	ajax
web service being called twice with jquery ajax function	ajax
Is there a super-high-load (Ajax) chat script out there?	ajax
What's the real advantage of using ScriptManager.RegisterClientScriptResource?	ajax
When Ajax should be used and when it should not?	ajax
ajax post special characters	ajax
Why don't browsers let you open a regular connection instead of Ajax or Comet?	ajax
how to get a js png fix to work on ajax calls	ajax
Response.redirect does not work with Ajax controls	ajax
Internet Explorer 7 Ajax links only load once	ajax
Problem adding item to sortable list	ajax
Gridview item preview using .net 2.0	ajax
Ajax locally testing	ajax
javascript or php - what is most efficient for updating?	ajax
Ajax - How to change URL by content	ajax
AJAX progress bar dispaying loading progress percentage for page load	ajax
Why use jQuery?	ajax
Pros and cons of MS Ajax vs. jQuery in an ASP.NET MVC app?	ajax
JQuery Ui or AjaxControlToolkit ?	ajax
AJAX Functionality	ajax
load a new page using ajax	ajax
Find string in httpxml.responseText	ajax
Grails formRemote redirects rather than to just call method	ajax
Ajax.Actionlink, how to get the form data to the controller action	ajax
AJAX presentation ideas!!	ajax
problem with cross-domain ajax calls...	ajax
How do I preview a url using ajax?	ajax
$.ajax() methods data	ajax
Extending Forms Authentication Timeout When Making AJAX Calls With jQuery	ajax
XMLHttpRequest vs Socket vs ?	ajax
Are Http-Only cookies a viable option for an AJAX website?	ajax
Can entire page be developed out of ajax in asp.net 3.5?	ajax
How to get around a 'NS_ERROR_ILLEGAL_VALUE' error using Ajax?	ajax
ASP.net AJAX Control Toolkit will not recognise my specified css classes in the autocomlete extender?	ajax
How can I setcookies in php server side with ajax and read cookies in the real time with ajax or javascript?	ajax
MaskedEditValidator DisplayMoney doesn't show up in Composite Control	ajax
jquery tab gives 404 sometimes when loading remote content	ajax
"Are PHP processes called via AJAX cancelled on ""ESC""?"	ajax
Back button functionality to webpage with form and search result + Ajax (ASP.NET)	ajax
Favorites star switching in Javascript	ajax
How to get Model errors in AjaxSubmit?	ajax
SQL query in tables side by side instead of one long table	ajax
"Integrating ""really simple history"" with Rails"	ajax
Ajax: Building HTML vs injecting HTML	ajax
Differentiating Between an AJAX Call / Browser Request	ajax
How to pass HTTP AUTH values via prototype Ajax.Request()?	ajax
What are the steps to create AJAX login in yiiframework?	ajax
Wait for getJSON response	ajax
How to pass values of a form to the sever with Ajax and Jquery?	ajax
How to post an image to a server using ajax	ajax
How to handle Multiple views using ajax and asp.net	ajax
JQuery AJAX Web Service call on SSL WebServer	ajax
Facebook Game Function, Optimizin a Call, and Loading Bar	ajax
async execution of tasks for a web application	ajax
Ruby on Rails Ajax rubberband	ajax
jQuery and JSON	ajax
Web-based JSON editor that works like property explorer with AJAXy input form	ajax
How to check if an ajax function is busy from a previouse call	ajax
How can you dynamically load Javascript functions using Ajax?	ajax
AJAX Enabled WebApplication	ajax
Submitting a Rails form with jQuery and Ajax	ajax
AJAX Testing Tools	ajax
Problem with AJAX and PHP	ajax
Twitter notification ajax bar, how did they do it?	ajax
How safe is it to send a plain text password using AJAX?	ajax
MVC architecture for front-end	ajax
ajax loading query in seperate div	ajax
"Ajax POST method converts my ""+"" value in a string  to "" "" why?"	ajax
What comparable Javascript function can reference a file like PHP's include()?	ajax
Changing a user created control based on content of input from JS tied textbox	ajax
why is Ajax.Autocompleter setting the style for the div container for the results to display:none ?	ajax
Ajax request and text/xml	ajax
Timeout setting of different browsers?	ajax
How can i get around the same origin policy?	ajax
Updating HTML via JSON/AJAX	ajax
IE6 Table cell alignment problem with ajax	ajax
"Implementing a text slider or ""slideshow"" with AJAX or JQuery"	ajax
AJAX boardgame runs fine in Windows, but not in Linux - PROGRAMMING QUESTION	ajax
GUI Toolkit for ASP.net	ajax
AJAX table update script	ajax
Accessing Web Services via AJAX?	ajax
AJAX script not working in Firefox	ajax
debugger warnings while viewing StackOverflow?	ajax
jQuery Post failing on production, works on local system	ajax
Popup blocked, jquery window.open in success: AJAX? outside ok.	ajax
Ajax jquery success scope	ajax
Run ready function on a page that is pulled in via AJAX	ajax
Scriptaculous autocompleter problem	ajax
bash completion for certain types of files in a special directory	bash
Safe rm -rf function in shell script	bash
How to convert timestamps to dates in bash?	bash
Delete all files but keep all directories in a bash script?	bash
bash: save in a variable the number of seconds a process took to run	bash
How to pipe a here-document through a command and capture the result into a variable?	bash
Bash (Mac): edit file and some if commands.	bash
Bash globbing - autoexpand for a few specific cases?	bash
Cat with new line	bash
In bash shell script how do I convert a string to an number	bash
Replace chars in file by index	bash
How do I include parameters in a bash alias?	bash
what is '$$' in the bash shell?	bash
redirect the stdin to come from a different terminal using Bash	bash
Functions in bash with special parameters	bash
Bash Menu:  Return to menu after selection made and executed?	bash
Using the result of a command as an argument in bash?	bash
Find file in directory from command line	bash
How do I alter tab autocomplete in bash to dive through folders?	bash
Bash / PHP quoting command line argument	bash
With bash, how can I pipe standard error into another process?	bash
Display output of a Bash command and keeping the output in a variable	bash
Find and Replace from a Bash Command	bash
Split string based on delimiter in bash?	bash
Handle special characters in bash for...in loop	bash
Bash: Echoing an argument after a slash inserts a blank character	bash
Unable to have a tab completion of system variables without a backward flash	bash
How can a bash script know the directory it is installed in when it is sourced with . operator?	bash
How can I hide a password/username used in a bash script for accessing MySQL?	bash
Copying a Directory Tree File by File	bash
Awk pattern macthing	bash
"Bash syntax: What is the ""<<""?"	bash
How to escape extended pathname expansion patterns in quoted expressions?	bash
Problem with non blocking fifo in bash	bash
how to scp across servers using bash?	bash
How can I assign the match of my regular expression to a variable?	bash
How to make a pipe loop in bash	bash
If text file is NOT empty, email me	bash
Extract Data from CSV in Bash script (Sed, AWK, Grep?)	bash
removing files starting with --	bash
BASH configration question, set alias as a sequence of commands?	bash
Limiting a script from sending alerts	bash
Messy bash variable	bash
Ignore a path entry with bash tab-completion	bash
Bash: add value to array without specifying a key	bash
Can this be done by sed?	bash
How to verfiy information using standard linux/unix filters?	bash
"How can you open files which contain the word ""exam"" in terminal?"	bash
putting the last command's wall time in bash prompt	bash
In bash, how can I print the first n elements of a list?	bash
bash/mysql complains about ) character	bash
Unable to scp from my server to my computer	bash
Extract filename and path from URL in bash script	bash
How can I ping many subsites ~/[0, 3].html in Bash?	bash
Unix commandline history substitution ^foo^bar (for multiple replacements)	bash
"solaris echo "" [ "" character problem"	bash
bash loop between two given dates	bash
Change current directory from a script	bash
bash script to restart Apache automatically	bash
Bash output as Applescript list problems.	bash
Count number of occurences of token in a file	bash
Boolean Expressions in Shell Scripts	bash
More simple math help in bash!	bash
Howto Pass A String as Parameter in AWK within Bash Script	bash
Why is my Bash script adding <feff> to the beginning of files?	bash
Unable to add a parameter to your command in Bash	bash
xargs doesn't recognize bash aliases	bash
"Using bash command line, how to add ""import package.name.*;"" to many java files?"	bash
What does ${2:-${1}} mean in Bash?	bash
Why ssh fails from crontab but succedes when executed from a command line?	bash
BASH script passing stdin input to a program and giving control back to user input	bash
Encoding Keyboard Command Onto Bash Script	bash
Calculate difference of numbers in two files	bash
What's the difference between $(...) and `...`	bash
Bash scripting: How do I parse the output of a command and perform an action based on that output?	bash
How to get the call graph of a program and with a bit of profiling information	bash
Bash One Liner: copy template_*.txt to foo_*.txt?	bash
Bash script with find command drops me to bash shell	bash
Unable to put a .txt -file to the end of another .txt -file	bash
Is it possible to detect 32 bit vs 64 bit in a bash script?	bash
How can I append text to /etc/apt/sources.list from the command line?	bash
BASH: Assign '&' to variable NOT as string	bash
Strange error checking if directory exists with Bash script	bash
Bash: Join elements of an array?	bash
Why bash ignore newlines when doing for loop over the contents of a C-style string?	bash
Simple Question: How to make a bash script that creates 40 simultaneous instances of a program?	bash
What is the most elegant way to remove a path from the $PATH variable in Bash?	bash
How can I suppress the output due to a SIGSEGV or a SIGFPE in a Fortran 90 program?	bash
Problem scripting a HTML header request with netcat	bash
Opening terminal windows with bash	bash
How to create a bash script to check the SSH connection?	bash
BASH : List files by last edited date?	bash
"How can I make the ""find"" Command on OS X default to the current directory?"	bash
writing bash script to change text and write to a log	bash
How do I reuse a command in bash with different parameters?	bash
How to check syntax in bash (without running the script)	bash
bash script shell input	bash
Hiding the text before an input to only $-sign in Bash?	bash
Bash TAB-completion inside double-quoted string	bash
How to match string/dir in a path using bash scripting	bash
Bash input/output in C++	bash
Bash: Recursively remove files	bash
Bash == operator in [[ ]] is too smart!	bash
Replace output in a loop in bash scripting	bash
Reading java .properties file from bash	bash
Reorganize folders with a script	bash
How can I ensure a Bash string is alphanumeric, without an underscore?	bash
Error in bash script while reading a file.	bash
"Is it normal for ""rsyslogd"" to cost 170M memory?"	bash
Syntax for a single-line BASH infinite while loop	bash
Connecting Two Bash Commands	bash
How to terminate script's process tree in Cygwin bash from bash script	bash
How to get the first line of a file in a bash script?	bash
pipelines vs for	bash
Determine if a function exists in bash	bash
Terminate running commands when shell script is killed	bash
{bash} howto insert a number into a string for wget	bash
Can a Bash script tell what directory it's in?	bash
Bash - Recursively Create Nonexistant Subdirectories	bash
Bash script does not continue to read the next line of file	bash
UNIX commands that support colours	bash
What are some of your favorite little known command-line tricks using Bash?	bash
How do I add a directory with a colon to a shell path?	bash
Do a complete flux of work on bash script	bash
How to use expr on float?	bash
What information can be gathered about remote host on ssh login	bash
bash return value	bash
How to delete files older than X hours	bash
How to get physical memory in bash	bash
How can I ssh directly to a particular directory?	bash
Locale-aware uppercase in Bash?	bash
How to get the name of the current git branch into a variable in a shell script?	bash
"""wget --domains"" not helping.. what am I doing wrong?"	bash
Bash: How to flush output to a file while running	bash
Bash scripting problem	bash
Interesting usage of tar... but what is happening?	bash
What happened to the TMP environment variable?	bash
How to program using cat	bash
Search and sort data from several files	bash
autoconf using sh, I need SHELL=BASH, how do I force autoconf to use bash?	bash
Bash script directory detection and creation	bash
Shell Prompt Line Wrapping Issue	bash
Notify upon background jobs finishing running in bash	bash
To understand Typeset for PythonPath	bash
Execute a shell command from a shell script without stoping if error occurs	bash
Extraction of data from a simple XML file	bash
BASH :: find file in archive from command line	bash
Bash: Delete until a specific file	bash
How to trim whitespace from bash variable?	bash
echo in a bash script changing '--md5' to '?-md5'	bash
Excel through OleDb shows numbers differently...depending on whether spreadsheet is open!?	excel
How to add user id in Excel header / footer?	excel
mass convert excel files into tab delimted text files	excel
Excel DateAdd not working properly ?	excel
"Excel Interop ""FindAll"" Method"	excel
What is the difference between a shared formula and an array formula?	excel
How do I create a toolbar in an XLA document?	excel
Excel merge and formatting	excel
Excel dynamic tables like functionality in web application	excel
Implementation of excel's ROUND function	excel
Run Macro to Update Cells	excel
How do I dynamically update the name of a worksheet in Excel?	excel
Excel - bottom border if text is present?	excel
Does anyone know the .net odbc driver connection string for excel 2003's xml spreadsheets?	excel
In excel automation, how to gracefully handle invalid file format error upon file opening?	excel
How do I create an Excel chart that pulls data from multiple sheets?	excel
API to write huge excel files using java	excel
another excel offset question	excel
Excel AutoFill problem	excel
Data extraction with Excel	excel
How can I hook up to Excel events in Javascript	excel
Excel Custom Format: How to set a format that handles numbers with optional decimals	excel
Conditionally linking cells in Excel 2007	excel
VBA editor auto-deletes spaces at the ends of lines	excel
Excel Print Worksheets by Name	excel
Changing Excel 2000 pivot chart unit	excel
Open a Specified File in Excel from a GUI - Borland C++	excel
How to stop EXCEL process from c#	excel
Excel: Change multiple formulae at once?	excel
Excel Interop Updating Formulas	excel
Load CSS In Excel	excel
Count rows until the sum value of the rows is greater than a value	excel
Excel 2003 data input and transfer it to another field which scrolls upwards to keep the last input and previous inputs	excel
Getting Excel 2003 to interpret a pasted number with leading zeros as text (works fine in 2007)	excel
write the data from an excel sheet to the text file though C#	excel
How do I make sure public VBA methods don't show up in the list of Excel macros?	excel
How can I perform a reverse string search in Excel without using VBA?	excel
Storing Data in MS Access and Querying it in Excel	excel
Round time to nearest 15min interval in Excel	excel
Help need Pls.... excel macro: compare and copy between worksheets	excel
Excel - Highlight active row	excel
What's XLSHTML?	excel
Best short examples of the need for Excel VBA	excel
How do I get my fortran output into excel?	excel
How to hide Excel window from a user	excel
Generating CSV file for Excel, how to have a newline inside a value	excel
Excel Formulas/VB: Show total based on date entry	excel
Determining size of printed page in Excel VBA	excel
Call Excel COM Addins functions using macro	excel
Multi-column sort with VBA	excel
What is the algorithm to covert an Excel Column Letter into its Number?	excel
How can I make my C++ ActiveX control print nicely in Excel?	excel
How to set programmatically two different Excel formulas for every other	excel
MS-Excel:  How to show the value of a combo box inside a locked cell.	excel
Error: <target>.ColumnName and <source>.ColumnName have conflicting properties: DataType property mismatch.	excel
How does one sum only those rows in excel not filtered out ?	excel
Excel cell Format Changes in text	excel
How to identify where the excel file use Excel 95 or Excel 97 specifications?	excel
How can I quote the data within my cells?	excel
Where is the best documentation of Microsoft Excel Biff format	excel
What's the best .NET library for parsing and generating Excel spreadsheets?	excel
VBA: Querying Access with Excel.  Why so slow?	excel
Is there any way to make Excel preserve XML attributes in root element?	excel
Is there a way to generate a Unique Identifier (in SQL Server newid()) in Excel 2007	excel
Field comparison in excel sheet	excel
Can I make a structured reference absolute in excel 07?	excel
Excel find and replace a character to create a new cell	excel
Excel: How to get a locale-independent printer name?	excel
Excel reference to .NET DLL breaks with new version	excel
VBA and Private Functions	excel
Excel replace value without losing formatting	excel
Copying Cells  from different sheets to one Main Sheet	excel
Writing a formula to a cell with OpenXLS	excel
Control 2 seperete Excel instances by COM independantly... can it be done?	excel
Excel OpenText method	excel
How to insert an excel chart into Word using AddOLEObject	excel
DSUM: How to define the criteria range using braces?	excel
Excel AVERAGEIF with TODAY() function as criteria	excel
Excek VBA worksheet.names vs worksheet.range	excel
removing some rows based on criteria - solving this by pivot tables	excel
Excel - Best way to graph the change of a cell as a function of the change of another cell	excel
Why does one ADO.NET Excel query work and another does not?	excel
What's the fastest way to walk through an Excel Range object backwards?	excel
Docking Custom Task Panes	excel
Drop-down list in Excel cell	excel
Reorder/shuffle values in a row/column in Excel.	excel
Firefox : Open XLSX file not saving file butn opening binary.	excel
Do Excel 2003 and 2007 use differnt file formats?	excel
Read/write Excel 2007 password-protected documents	excel
Where to find out the method used for excel functions	excel
How to force an order of cell evaluation on Excel	excel
Server moved, now MS Excel 2003 queries won't work	excel
Excel VBA development best practises	excel
How can I use Excel for project management?	excel
Excel detect inactivity	excel
Pasting the same text copied from different sources behaves differently in Excel	excel
Problem with toolbar in Excel 2003	excel
Unable to load the Excel 2003 Add-in	excel
How to write an Excel function which returns a value from an SQL database?	excel
Easily using  Excel data in SQL Server	excel
Refresh Excel VBA Function Results	excel
Excel Interop: Formatting Footers	excel
How to store information in a Excel WoorkBook	excel
How do I create an excel macro that changes the height of a cell	excel
Read Excel File Data From HttpPostedFileBase object	excel
Can I get relational data into an Excel Pivot Table	excel
Alternating coloring groups of rows in Excel	excel
Looping Code/Skipping Rows	excel
Excel Replace all found chars	excel
Excel 2003 VBA error 1004 after XML data import	excel
Identifying Different Excel File Formats	excel
Tracking e-mails in outlook with excel	excel
Changing Legend Type in Excel	excel
Copy and paste cells if Duplicate columns , Excel Macro slightly different question	excel
First non-empty cell in a spreadsheet row	excel
"Excel: mapped XML data and the ""number stored as text"" error"	excel
Difference between print and print preview events in excel vba	excel
Excel: Removing duplicates in one column while retaining highest value in the adjacent column.	excel
How to detect if filter(s) changed on a worksheet?	excel
"How to add ""Select Data Source"" to my Excel appliation?"	excel
xml excel realtive path issue	excel
Runtime error 1004: Application-defined or object-defined error	excel
are there any good unit testing packages for excel	excel
Exporting Native Excel 2007 Files From .NET	excel
Excel - IF and SEARCH functions	excel
Tab order VSTO Excel	excel
What options do I have for reading Excel files and evaluating formulas in C#, Java and PHP?	excel
xls to text converter	excel
Hiding Page Breaks in Excel	excel
Excel Floating Point Arihmetic - What Type Does It Actually Use	excel
Excel filter questions	excel
EXCEL Formula or VBA To Extract Data Based on Another Cell's Data	excel
MS Excel: how to enter free-form text in cell with drop-down-list?	excel
Combing Multiple Excel Files into Single Excel Workbook with Multiple She	excel
Extract table from html to excel from the command-line	excel
Referencing an Excel address within a cell, but also additional text	excel
Excel UDF formula does not appear.	excel
Fill array with consecutive integers	excel
Best free Excel writer for C# to output datatable to excel	excel
How do I get a range's address including the worksheet name, but not the workbook name, in Excel VBA?	excel
How to send an email attachment with signature in excel	excel
TAB separated txt file from Excel  VBA/MACRO	excel
How to convert Excel sheet column names into numbers?	excel
How do I return the address of the currently copied range in Excel?	excel
What is the best practice for allowing users to upload excel document?	excel
Concurrent sum	excel
How can I make MS Query (in Excel) see tables with field-level security on SQL Server 2005 or later?	excel
Excel automation. Need to multiple items from a Range	excel
How to convert Excel to XMl using java?	excel
"Excel VBA: force refresh of ""last"" cell of the worksheet"	excel
Determine if a sequence contains all elements of another sequence using Linq	linq
When to use .First and when to use .FirstOrDefault with LINQ?	linq
LINQ Object Persistance	linq
LINQ group by question	linq
Linq syntax in VB.NET	linq
LINQ (or anything) to add items from an objects list to the objects row in a datagrid?	linq
How to get the index of a record ordered by something in Linq?	linq
Updating a column value in resultset returned by a Linq query	linq
Linq Select Certain Properties Into Another Object?	linq
"Why does LINQ treat two methods that do the ""same"" thing differently?"	linq
Sum of hierarchical data using LINQ?	linq
Using XQuery in Linq To SQL?	linq
How do I most elegantly express left join with aggregate SQL as LINQ query	linq
Linq - Using Except() on a Generic collection	linq
How to assign null to sql entity columns	linq
How do I navigate through multiple relationships using LINQ to Entities?	linq
How do I decipher the Select method docs on MSDN?	linq
Checking if Var from LINQ query is Null and returning values older than x	linq
linq case statement	linq
If all my sql server database access is done thru stored procedures.....	linq
What's the smart way to implement OrderBy / ThenBy?	linq
Need help with a linq query please!	linq
How do you do a join in LinqToSQL?	linq
How do you page a collection with LINQ?	linq
linq cache and disposing datacontext	linq
Stuck on a subquery that is grouping, in Linq`	linq
Does LINQ's ExecuteCommand provide protection from SQL injection attacks?	linq
LINQ - NOT selecting certain fields?	linq
How to use LINQ to compile a lambda expression to custom SQL or otherwise?	linq
Linq to SQL Performance using contains.	linq
Running out of DB connections using LINQ to SQL	linq
Updateable Data Grid using Linq to SQL in WinForms	linq
How to write that special select query	linq
Add property to LINQ that is combination of multiple tables?	linq
How remove empty element from string array in one line?	linq
LINQ and dbml file	linq
Stored Procedure & LINQ, Dmbl File unable to interpret the result set	linq
Preserve order of values with linq and ToLookup()	linq
LINQ grouping in C#	linq
Convert Dataset to IQueryable<T> or IEnumerable<T>	linq
Relational databases and OO languages	linq
LINQ Query to retrieve multiple levels of relational data	linq
Why I can't use .CopyToDataTable in LINQ query?	linq
How LINQ works internally?	linq
Dynamic selects in LINQ	linq
Simple LINQ query	linq
How to compare dates in LINQ?	linq
How to deal with a flaw in System.Data.DataTableExtensions.CopyToDataTable()	linq
How can I write the following more elegantly using LINQ query syntax?	linq
Linq - Excluding items from different list types.	linq
LINQ WHERE query problem in C#	linq
How to deal with datatypes returned by LINQ	linq
Manually select related table data when quering in LINQ to SQL	linq
IEnumberable.Except wont work, so what do I do?	linq
Filtering collection with LINQ	linq
Group By Dates using Linq	linq
LINQ Query - Explanation needed of why these examples are different.	linq
How .NET 3.5 (lambdas, Linq) evolved	linq
Flattening Linq Group query	linq
LINQ External Mapping to Class Library	linq
What is the LINQ to XML equivalent for this XPath	linq
Accessing grouped sets of objects for a ListView	linq
Managing LINQ to SQL .dbml model complexity	linq
Force Full Path in the Connection String of Linq DataContext	linq
How do I fill a DataSet or a DataTable from a LINQ query resultset ?	linq
ADO.NET Data Service not dynamically updating	linq
Linq - sum child field value when child records query ganareted by diffrent func	linq
linq to sql	linq
Using LINQ with stored procedure that returns multiple instances of the same entity per row	linq
What is the equivilent C# 3.5 Linq to SQL for this?	linq
Filtering Null values in Select	linq
LINQ Refactoring	linq
LINQ JOIN in String Array	linq
Using LINQ to get column value from column name when you have the row?	linq
Linq over DataTable  with .Skip() and .Take() method	linq
Where and When to use LINQ?	linq
Examples on when not to use LINQ	linq
Is there any performance difference between myCollection.Where(...).FirstOrDefault() and myCollection.FirstOrDefault(...)	linq
LINQ to SQL - select where text like string array	linq
Nested Linq Queries	linq
Sub Query Where X in (from... ?	linq
Can I execute a LINQ to SQL query from within a LINQ object?	linq
LINQ to SQL inserting large object from .NET	linq
Is DB_LINQ + Non-MSSQL Database an acceptable substitute for LINQ to SQL with MSSQL?	linq
Is there a LINQ library for C++?	linq
Nested Linq Min() crashes Visual Studio	linq
Automatically Compile Linq Queries	linq
Linq Efficiency question - foreach vs aggregates	linq
why use a web service with linq to sql?	linq
linq subquery returning null	linq
How do I translate this GROUP BY / MIN SQL query into LINQ?	linq
How to replace xml content in conditionally selected elements using linq (VB 2008)	linq
LINQ and a natural sort order...	linq
How do I get the MAX row with a GROUP BY in LINQ query	linq
LINQ to Objects - Does Not Contain?	linq
Adding related records in LINQ	linq
LINQ with Subquery/Group By/Join	linq
Write a linq expression to select a subtree of items	linq
What is the difference between Linq and IQueriable	linq
linq to sql + update table	linq
LINQ ISNULL	linq
Returning multiple streams from LINQ query.	linq
LINQ to SQL and object lifetimes, references vs. values	linq
Clever tricks to find specific LINQ queries in SQL Profiler	linq
DataContext.CreateDatabase Attribute problem	linq
Linq to sql truncating string returned by Stored Procedure	linq
LINQy way to check if any objects in a collection have the same property value	linq
LINQ - which layer should LINQ typically fall into, DAL ?	linq
Why would a Database developer use LINQ	linq
How to get Max String Length in every Column of a Datatable	linq
What design pattern should I use to create an easy binding map between a query and textboxes for Linq search screens?	linq
LinqDataSource and DateTime Format	linq
How can I perform a nested Join, Add, and Group in LINQ?	linq
Is List.ForEach technically a part of LINQ or not?	linq
Getting 'Data source is an invalid type' when binding Linq query to Gridview	linq
Linq To XSD at runtime.	linq
Difference between these? Linq to Sql, Linq, Typed Datasets, Ado.net	linq
VS2008: Make a non-LINQed website LINQed	linq
LINQ: How to get items from an inner list into one list?	linq
Linq: recursively get children	linq
How do I find a subset of items in two sets of data that partially differ?	linq
Zipcode to city/state look-up XML file?	linq
LINQ vs stored procedures?	linq
LINQ to SQL: How To Extend An Entity Class With A Column Alias	linq
linq operators like in	linq
Linq To SQL Without Explicit Foreign Key Relationships	linq
A range of objects from a list	linq
LINQ: Using INNER JOIN, Group and SUM	linq
How to extract a meta tag from XML/HTML using Linq?	linq
LinQ to XML query	linq
LINQ with 3 Tier	linq
Is LINQ DOA?	linq
How to Sum the duration in Gridview List by using LINQ to SQL?	linq
Entity Framework - dynamic sql	linq
What does full LINQ support mean?	linq
How do I do this SELECT statement with LINQ?	linq
While using Linq sum rounds up the values. How to avoide that?	linq
Checking if no elements in IEnumerable(Of T) - Linq element and quantifier operators	linq
LINQ to XML: parsing XML file which one of nodes presents type of another node	linq
"Does ""Select New"" in linq trigger an evaluation / load?"	linq
Is it possible to change &amp; to & in the results from a LINQ query?	linq
How do I build up LINQ dynamically	linq
Linq to Sql Add Child records	linq
Can I get specific metadata from a Func<T, object>?	linq
LINQ to XML when a node does not exist	linq
"LINQ UpdateCheck on parent ""LastUpdatedOn"" field while updating children"	linq
Linq Not Retrieving Correct Items in a Big Table	linq
LINQ to DATASET update with a stored procedure	linq
What are the alternatives to using Expand in a LINQ to ADO.net Data Service Query?	linq
Linq to XML performance - Standalone test vs Very large web application	linq
How to check if Qt GUI application is already running (in Linux)?	qt
How could I use the QColorDialog widget inside another widget not as a separate dialog?	qt
breakpoints not working after installing valgrind	qt
Linking Qt in a dynamic library	qt
Inheriting std::istream or equivalent	qt
How to reverse a QList?	qt
QTabBar vs QTabWidget	qt
How to deallocate memory when a Qt window closes?	qt
Qt Build Error	qt
In QT, for a context menu item, how to hide the space of the icon	qt
Should I use QCoreApplication::processEvents() or QApplication::processEvents()?	qt
Linking GUI app against a static lib in QtCreator	qt
QTreeView stylesheet customization problem with scrollbar	qt
Show/hide QDockWidget?	qt
Qt4.5: Using event-loop based localsocket before app.exec	qt
How do I tell Qt to always show an editor in a QTableView?	qt
How does QWidget size when used as a window?	qt
Does Qt have a C interface?	qt
Qt: Do events get processed in order?	qt
When to use signals and slots and when not to	qt
Problem with selection rectange	qt
Figuring out which menu item was triggered in Qt	qt
"How to implement the ""Edit"" menu with ""Cut"", ""Paste and ""Copy""?"	qt
How to get a line number when parsing with QXmlDefaultHandler?	qt
retrive the text in a specific cell in a QTableWidget?	qt
(C++ QT) QList only allows appending constant class objects?	qt
How to solve QPixmap::fromImage memory leak?	qt
loaded image Qsize	qt
QMetaObject Compiler explain?	qt
Clean up before closing the QCoreApplication.	qt
What is the best way to make a QTableView's cells have up and down button pushed states in Qt?	qt
How to run parallel codes using QT ?	qt
Is it possible to use Qt threading without inheriting any Qt object?	qt
QWebView not loading external CSS	qt
How to I authenticate with a ISA proxy from my application seemlessly?	qt
"Creating ""pretty"" Qt Custom Widgets"	qt
how to emit cross-thread signal in qt?	qt
Thread pool in Qt 4.3	qt
Why does QWebFrame::evalutateJavaScript do nothing in this case?	qt
How to create a QWidget with a HWND as parent?	qt
Contents of PyString in Qt Creator debugger?	qt
How can I implement a blocking process in a single slot without freezing the GUI?	qt
Mixing Qt and Boost	qt
QT Repaint/Redraw/Update/Do Something!	qt
Interface Segregation in Qt	qt
Using .pri files in Qt	qt
How to make item view render rich (html) text in Qt	qt
How to manipulate pages content inside Webkit window (Using QT and QTWebKit)	qt
"How can I hide/delete the ""?"" help button on the ""title bar"" of a QT Dialog?"	qt
Qt: How to set QMenu to align to the right of a toolbar?	qt
get several values from the user in QT	qt
Why don't I have setTextFormat in my QTextEdit? [Qt] [C++]	qt
Question about what I should have before Connect	qt
Hand Coded GUI Versus Qt Designer GUI	qt
How to get the paint event for Buttons in QT	qt
Can I insert a test into a qt event window?	qt
QGraphicsView and QGraphicsItem: donÂ´t scale item when scaling the view rect	qt
QPainter and QTimer	qt
Building multiple targets in Qt / Qmake	qt
QObject::findChild returns wrong address when used with a custom widget plugin	qt
QDir and QDirIterator ignore files with non-ASCII filenames	qt
Using Qt in a pre-existing x-platform project?	qt
Text under a widget added with QToolbar.addWidget()	qt
Connecting to a signal hidden by QMessageBox	qt
Problem with QSqlTableModel -- no automatic updates.	qt
Qt how can i get content of web-page?	qt
QtScript: crash on 64-bit windows.	qt
Qt QFileDialog QSizePolicy of sidebar	qt
PyQt, Qt, one event handler working with many items	qt
Does Qt provide a class that represents an IP address?	qt
settings from qt project file in code	qt
QT creator Installation error? - Snow Leopard	qt
Qt QPlainTextEdit background	qt
In Qt, how do I align form elements in different group boxes?	qt
Displaying WebCam video with Qt	qt
Selecting an index in a QListView	qt
things to consider for qt application development on winXP on atom processor	qt
Qt: QGraphicsScene not updating when I would expect it to.	qt
Closed state of QDockWidgets not restored by restoreDockWidget?	qt
How to use Intel C++ Compiler with Qt Creator	qt
"Any way to ""bulk load"" a Qt data model to avoid excess signal invocations?"	qt
Problem in Line Editor in Qt?	qt
QWidget::find(hwnd) always returning 0	qt
QT with C#/.NET in Visual Studio 09	qt
were is the mistake in my code	qt
QT: Hide the title bar of a dialog/window	qt
Compiling QT-Creator with mingw	qt
Handling a QTextEdit from another form	qt
Qt or Delphi... If you were to choose one over the other?	qt
Qt Icon embedded in Executeable	qt
Newbie QT question about connect	qt
Force library linking with Qt and google test	qt
What does the following function do?	qt
What's the difference in the Visual Studio integration tools for QT?	qt
QT (4) equivalent macros/methods/constants for their Win32 API counterparts?	qt
Is anyone using valgrind and Qt ?	qt
How to select a subset of rows of a QTableView that match certain criteria?	qt
Linux sockets communicating with QTcpSockets in Qt 4	qt
Qt does not create output files in debug/release folders in Linux	qt
Is there a way to determine if a top level Qt window has been moved?	qt
Qt, set background images loaded from disk	qt
Qt auto software version?	qt
implement thread for consuming operations in Qt	qt
Is QHash::contains method case-sensitive or case-incensitive?	qt
QT set window background	qt
Qt widget disobeys drop in Windows	qt
Reading from a file not line-by-line	qt
QListWidget on freemantle	qt
Sharing same model in two QGraphicScene instances in Qt	qt
How to change the text color of QListWidget	qt
How can I view programmatically what resources Qt thinks it has?	qt
Qt QTableView and horizontalHeader()->restoreState()	qt
How to build latest Qt from Git repository on windows?	qt
Find QWidget of single instance Qt application	qt
"mingw spitting countless warnings about ignoring ""dll import"" attribute"	qt
Qt Threading with signal slot?	qt
Help Recommend Qt Opensource Project	qt
Is there a way to make drawText() update a QPicture's bounding rect?	qt
Deleting QWinWidget	qt
QGraphicsView/Scene - multithreading nightmare	qt
How to install a plugin for QtWebKit	qt
How to link Qt to and already existing MinGW installation?	qt
Hierarchy in Qt [C++]	qt
How to specify monospace fonts for cross platform Qt applications ?	qt
How to access to parent widget on qt?	qt
Import Qt resources when are main.cpp and GUI classes in dependend static lib project,	qt
Qt and serial port programming	qt
Qt Play/Pause Action?	qt
Qt::Tool window diassapears when application become inactive.	qt
setRawHeader don't follow elements in the web view	qt
Why is Qt looking for my slot in the base class instead of derived one?	qt
is it possible to use QtConcurrent::run() with a function member of a class	qt
How can I enable auto-updates in a Qt cross-platform app?	qt
How to make modeless dialog stay on top of its parent in Solaris CDE	qt
Drag & drop with .ui files	qt
Question about QThread implementation	qt
install EventFilter on QWidget (qt4.4.3/kde4)	qt
Is it possible to use QFontDatabase::addApplicationFont() in Symbian?	qt
How to format/change qmake/make output	qt
Reading the final name of a file downloaded using QNetworkAccessManager	qt
Embedded JPG resources not loading in Qt application	qt
Passing data around with QMimeData in Qt drag and drop	qt
Is it possible to sort numbers in a QTreeWidget colum??	qt
How to create a bold, red text label in Qt?	qt
Callback for Button in QtCreator?	qt
"QCalendarWidget as ""Pop-up"", not as new Widget?"	qt
Qt: What unit-testing framework?	qt
Unable to build 32-bit Qt Mysql plugin with MinGw	qt
How to save unsigned char to MySQL	qt
Removing arrows from scrollbar in Qt	qt
display a 'view' list within a composite layout in drupal	drupal
Crucial Drupal Modules for Dynamic Site Development	drupal
Drupal | How do you integrate a module into views?	drupal
Theming for/with javascript?	drupal
RSS <link> tag not appearing in <head> of Drupal view page display output	drupal
what is the purpose of form_state , delta variables in drupal	drupal
How can I add an onmouseover event to all drupal forms?	drupal
drupal 6: how to email users of tasks due (week b4, day before, and overdue)	drupal
drupal - override form action?	drupal
Notification mail in open atrium	drupal
drupal search on the top taxnomy term	drupal
Drupal: Sharing content across Multisite	drupal
"How to fix ""user warning: ... cache.inc on line 109."" from a Drupal site?"	drupal
Fixing problems on a site that only breaks on IE7	drupal
How to solve the problem with the use of deprecated function ereg() of PHP 5.3.0 in Drupal  6.13	drupal
Drupal location autosuggest doesn't recognize provinces	drupal
best way to give editors ability to assign background images in drupal 6	drupal
filtering a Drupal View with ORed criteria	drupal
How to set up Drupal default front page (view) to open in other language than default	drupal
Drupal: How to theme node add/edit page for specific node type?	drupal
Drupal - RSS Item Edit - Seek Advice	drupal
Theme a CCK input form in Drupal 6	drupal
Remove One Time Login System in Drupal Froget Password	drupal
*Simple* FLV player (no logo, no advertisement)	drupal
Creating drupal pages (nodes) automatically from other (xml) content	drupal
Is there a Drupal module for importing text and images?	drupal
How to write custom reports in Drupal	drupal
slideshow module for drupal	drupal
drupal :how to pass current userid as argument	drupal
Translating external api results in Drupal	drupal
Drupal: Views Grouping Issue	drupal
Drupal DATABASE deployment strategies?	drupal
Drupal Form-API: #field_prefix doesn't work on textfield	drupal
Access to a Drupal site via an HTTP API	drupal
Drupal - Migrating to new server	drupal
Drupal 7: How do I import a RSS feed?	drupal
Drupal: add contact form as field to user profile	drupal
Drupal/Drush: How to bundle a project.profile within a project.make?	drupal
Drupal: re-selecting taxonomy terms in advanced search	drupal
Drupal 6 parse incoming POST data	drupal
Drupal: Checking to see if User Has Picture	drupal
How to disable personal contact form option in drupal user account creation.	drupal
Drupal Custom Form Arrangement/Placement	drupal
Integrating Drupal with OpenERP.	drupal
Drupal - How to display the list of new fields created from CCK on home page	drupal
Dynamic links in Drupal	drupal
Can CCK take care of my fields for a programatically defined node type in drupal?	drupal
Drupal: customizing the look of WorkFlow module	drupal
Grouping a Views table.	drupal
Drupal Search Behavior	drupal
Modifying content type INPUT page?	drupal
Most stable Linux Distribution for Drupal?	drupal
Cannot see my drupal page, when set with online server.	drupal
Consuming SOAP Web Services in Drupal from C# client	drupal
"How do I add  a ""last"" class on the last <li> within a Views-generated list?"	drupal
Drupal: allowing users to sign up to content using a form	drupal
How to get all paths in drupal install	drupal
Drupal Custom Menu Styling	drupal
DRUPAL: use tags as filter in Views	drupal
How to create relationships with the friendlist module in Drupal?	drupal
drupal_add_css not working	drupal
"Drupal 6 Views: Constraining fields which are not the ""primary"" node"	drupal
Drupal: passing variable from preprocess to template.php?	drupal
Silently modifying nodes	drupal
Execute jQuery function on expanding fieldset in Drupal	drupal
Drupal: Adding content to a View	drupal
Drupal watchdog database table flooded with same message over and over?	drupal
Google Analytics-like module for Drupal site behind firewall?	drupal
"Creating a ""Universities Attended"" Profile field/block (Drupal)"	drupal
How to store Blobs in Drupal?	drupal
Adding a rule that checks if the user's role has changed?	drupal
Cannot enable Clean URLs on Drupal after upgrading from 6.12 to 6.15	drupal
Including javascript in a drupal page or form	drupal
Drupal Views (Page) Using Human-Friendly Path	drupal
Pass variable from module to theme template when using drupal_render	drupal
Drupal 6: Group multiple values in tpl.php	drupal
Where to place hooks in Drupal?	drupal
How to display a list of nodes and details of a single node in Drupal	drupal
How to turn off authoring information for a drupal page	drupal
Drupal 6: CAPTCHA on a custom form	drupal
Drupal reserve checkbox module?	drupal
Google Adwords conversion on form submission in Drupal	drupal
"Drupal flushing ""Page requisites"" cache also deletes javascript files"	drupal
Integrating Several Drupal Sites	drupal
Looking for advice on the best way to show BIRT reports in Drupal	drupal
drupal persistent login, why use?	drupal
In Drupal 6, is there a way to take a custom field from the latest post to a taxonomy term, and display it in a view?	drupal
Problems using MySQL instead of MySQLi	drupal
How to include drupal form elements in a data table	drupal
drupal  problem with creating word document files	drupal
How to change Drupals menu alternatives for creating a page	drupal
Drupal sudden excessive memory usage	drupal
Create block that displays preconfigured-term search results	drupal
"Drupal Webforms module - Form results say ""Array"" instead of form values"	drupal
Drupal is allowing viewing of unpublished content	drupal
How to add classes for styling to Drupal when using menu_block?	drupal
Sql Query to XML document inside Drupal	drupal
Creating a custom content type in drupal	drupal
Drupal CCK: how to output a node teaser with its fields?	drupal
how to print just the popup window	drupal
Export Drupal Content?	drupal
Access Drupal views arguement in the same views header or footer section.	drupal
drupal : how to restrict users to only be able to see one contentType	drupal
Custom URL aliases in Drupal 6	drupal
Changing CCK Title for Form	drupal
Theming Drupal book hierarchies	drupal
Where does Drupal store NODE data?	drupal
Is there a way to get distinct taxonomy terms in drupal views?	drupal
Invoking drupal	drupal
Drupal: Url alias for language frontpage	drupal
disabling Drupal's CSS/JS aggregation for admins	drupal
Redirect After Registration in Drupal	drupal
Scaling Drupal	drupal
Change Ads automatically Drupal Ad module	drupal
Get all Comment ID's within a Drupal node	drupal
Assign a taxonomy term to a view instance	drupal
Creating New Accounts Remotely with Drupal	drupal
Drupal: updating with Drush doesn't change update status	drupal
Drupal, MSSQL and IIS7	drupal
how do I extend a contributed module in drupal	drupal
Drupal form validation not working for me	drupal
Searching views in Drupal	drupal
PHP / Drupal, Session Storage and encryption	drupal
Drupal Add Static link to a view	drupal
Using a Drupal variable in SQL query	drupal
How to port from Drupal to Django?	drupal
Drupal + Nginx + Php-cgi :  502 Bad Gateway error	drupal
Should I use ImageMagick or GD2 with ImageAPI in drupal?	drupal
How powerful is Drupal really?	drupal
Anyone familiar in Drupal 6 Services module specifically node.save	drupal
Need some Drupal best practive guidance.	drupal
Drupal Theming - Different themes for each webform	drupal
Drupal path alias not found	drupal
Drupal: module, cck or other	drupal
Link between CCK field and view	drupal
How do I group similar catalog products (CD & mp3) on the landing page of my Ubercart store?	drupal
Dynamic menu item in Drupal?	drupal
Drupal development: performance	drupal
"Forcing ""drupal_set_message"" messages to appear immediately?"	drupal
How can I disable Theme Info module in Drupal when it takes up too much memory to access the admin>>modules page?	drupal
What's the drupal way to define global constants?	drupal
fetching only part of a Drupal 6 menu	drupal
Drupal jQuery won't load in IE using $(document).ready()	drupal
Multi-lingual Drupal Site	drupal
Drupal registration to create the new user account also in a 3rd-party system	drupal
Get Drupal Paths During node 'insert' operation with Pathauto enabled?	drupal
Drupal: Which MySQL do I need?	drupal
Drupal VS Zikula	drupal
How can I programatically add images to a drupal node?	drupal
Drupal: Views: grouping relationship in block list	drupal
Configure mod_jk with  mod_rewrite	apache
apache + lighttpd front-proxy concept	apache
How to turn off optimization (-02) for apache modules built with APXS	apache
Internal redirects after using Apache's mod_rewrite	apache
Listing Apache Derby Active Connections	apache
internally redirecting to another file in Apache	apache
Apache modrewrite htaccess problem	apache
Can I make an Apache running on Windows case-sensitive?	apache
Apache rewrite rules redux	apache
Can anyone tell me why Apache will not work, for my Django?	apache
Set up Apache for local development/testing?	apache
How to get Tomcat Working on WIndows 7?	apache
using apache location directive to list folders from trac	apache
many instances of apache get spawned with Passenger/Rails	apache
Problem with URL rewriting for same .php page	apache
Why are event-based network applications inherently faster than threaded ones?	apache
Apache rewrite URL but don't rewrite certain folder	apache
Apache + SSL Error 336027900	apache
Example of using AuthType Digest to authenticate a user once across sub-domains?	apache
How do I fix this apache error log issue? Mod Deflate	apache
mod_rewrite: Rewriting / to cgi script	apache
Mod Rewrite : Replace all _ (underscore) with - (hyphen)	apache
Apache setting mod_auth_ldap require settings per sub-directory	apache
Why browsers sometimes render site bad?	apache
It there a framework for running unit tests on Apache C modules?	apache
Using mod_rewrite with mod_vhost_alias	apache
Using random folder name on web server to restrict access to it - bad idea?	apache
Best practictes for configuring Apache / Tomcat	apache
mod_rewrite depends on what other modules?	apache
"Why does running ""apachectl -k start"" not work, but ""sudo apachectl -k start"" does?"	apache
How to Debug an Apache Module	apache
Apache/PHP - alias outgoing URL	apache
Mod-rewrite has revealed itself	apache
Remote access to apache2 server	apache
Need help with Apache Rewrite issues	apache
Setting expires header for a specific URI?	apache
PHP session timeout callback?	apache
How to properly set up svn on web server?	apache
What are the minimum hardware requirements for IIS 6.0 and Apache 2.x?	apache
Redirect subdomain to /folder	apache
apache plgin for NTLM for Getting  log in user name.	apache
Using custom response headers to help detect site transfers	apache
Apache rotate Access and Error logs	apache
Rewrite rules - going outside the docroot.	apache
Conditional php_flag statements in .htaccess	apache
Apache RequestHeaders for Software-As-a-Service under Rails	apache
Can I use resources licenced under the Apache Public License in my commercial app?	apache
finding apache build options	apache
Map URL to MySQL databases	apache
How can I convince mod_rewrite to stay away from my Subversion repositories?	apache
apache mod_rewrite one rule for any number of possibilities	apache
What's a good library to manipulate Apache2 config files?	apache
Compression of content on Apache and Tomcat	apache
Apache RewriteRule not working without Page # specified.	apache
AJAX/NPH Scripts under Apache 2.2.9 - without the nph-name preface?	apache
Apache/PHP closes connection after short time (12 secs)	apache
Why isn't this rewrite rule working?	apache
cannot re-install apache 2.2 services on XP through xampp	apache
Apache rewrite url need help	apache
Apache with mod_dav_svn starts to consume a lot of memory	apache
Apache log analyzer which outputs user flows	apache
Apache + Tomcat: Using mod_proxy instead of AJP	apache
apache mod_proxy_html on Ubuntu ProxyHTMLEnable not working	apache
How to write this rewrite rule in Apache?	apache
Rewrite only a specific file using MOD_REWRITE	apache
How to understand which modules must be configured in httpd.conf (Apache)	apache
How to rewrite URL in Tomcat 6	apache
Can apache's ProxyRemote be used to proxy HTTPS requests to mongrel for processing?	apache
installing additional apache modules	apache
How to fix a misconfiguration with Phusion Passenger and a VirtualHost directive?	apache
Apache: Deploying a new site to the server	apache
Running multiple sites on a LAMP with secure isolation	apache
Apache and IIS side by side (both listening on port 80) on windows2003	apache
how to detect that localhost web site is closed and then shout apache web server	apache
Launch Apache 2.2 on static IP	apache
resolving sub-domain in apache	apache
mod_rewrite redirect to URL with propietary protocol	apache
IIS equivalent of VirtualHost in Apache	apache
How do I create a custom directive for Apache Velocity	apache
500 error when trying to add expires header to .htaccess	apache
How to view error messages from ruby CGI app on remote server?	apache
Suggestions for Fun Web Programming Projects at Home	apache
mod rewrite setup	apache
Proxy URL without authentication	apache
Proxy choices: mod_proxy_balancer, nginx + proxy balancer, haproxy?	apache
It seems the mode rewrite in .htaccess apache is not working	apache
shell script to add list of domains to apache vhosts	apache
apache ProxyPass: how to preserve original IP address	apache
Why does Apache return a 503 error for ant's get task, but not for my browser?	apache
Seamlessly direct multiple domains to a single set of PHP files?	apache
How to find where Apache's httpd.exe is installed?	apache
How to verify that mod_rewrite is working	apache
Duplex or request-reply with Apache ActiveMQ WCF Binding configuration question	apache
Can't get Xdebug to work on Windows 7	apache
What is Apache process model?	apache
Apache AllowOverride equivalent in Lighttpd	apache
Why do some setups front-end Glassfish with Apache?	apache
Apache - Prettifying URLs with mod_rewrite while also catching some edge cases	apache
Apache rewriteRule for root directory	apache
How do I remove URL parameters from an apache 301 redirect?	apache
How to find & fix memleaks inside Apache + PHP + Win2k3	apache
Apache mod_rewrite: redirecting subdomains to the HTTPS login page	apache
htaccess file restriction	apache
Self-extracting web environment	apache
What's wrong with this mod_rewrite statement?	apache
URL Redirection for SSL virtual hosts	apache
How to force a browser to refresh a cached version of a webpage	apache
Apache Rewrite does not redirect	apache
What's the best way to examine apache's access.log files?	apache
How to make a file extension downloadable?	apache
What is CGI and what are CGI Scripts?	apache
Dynamic DNS on your own server	apache
Regular expression with RedirectMatch does anything	apache
Communicate to Apache Server	apache
Use HTTP Auth only if accessing a specific domain	apache
How to set up virtual hosts on Apache 2.2	apache
HOWTO transfer a request made to an Apache server to an IIS server without using a URL redirect?	apache
using BOSH/similar technique for existing application/system	apache
Apache rewrite based on subdomain	apache
mod_rewrite not working as internal proxy	apache
What do you recommend for setting up a shared server with php	apache
Apache: RewriteRule leads to segfault	apache
Run a php app using tomcat?	apache
Apahe configuration with virtual hosts and SSL on a local network	apache
apache rewrite htaccess	apache
Is there a difference between installing mod_python via httpd.conf and conf.d in apache?	apache
Setting up Ruby CGI in Apache	apache
Mixing RewriteRule and ProxyPass in Apache	apache
Tutorial for developing Web Services with Apache Axis 1.5	apache
Bandwidth throttling for Apache<2.2 on Windows (mod_throttle?)	apache
"what is the real version for ""Apache/2.0.63 (Unix)"" in a HTTP response header?"	apache
What's the best php / mysql emulator	apache
mod_rewrite: setting GET depending on HTTP_HOST	apache
Apache 13 permission denied in user's home directory	apache
Blocking specific extensions in htaccess	apache
Implementing Tiny MCE As Local HTML Editor	apache
Multiple RewriteConds and RewriteRule Stacked Together	apache
Apache Rewrite Rule Regex Problem	apache
How to hide distributed servers under a single domain?	apache
Is  SVNAutoversioning directive in apache subversion imporant?	apache
Simple symlink in web root returns access denied	apache
HTTP compression - How to send precompressed files that exist in a EAR file?	apache
Apache server cache images	apache
Apache RewriteRule .* index.php [NC,L] Not working	apache
mod_rewrite causes apache to crash with Rewritemap prg directive	apache
using RewriteCond, can i change how fast content is served to users in different parts of the world?	apache
Apache Mod_Rewrite RewriteRule strange behaviour	apache
Apache getting denied access to a directory on my local server	apache
htaccess 301 Redirection for Multiple Files	apache
Browser language based 404 pages with mod_rewrite how to	apache
"""Go To Definition"" in Visual Studio only brings up the Metadata"	visual-studio
Where are project level imports stored in Visual Studio 2008?	visual-studio
Any clever way to launch a makefile in Visual Studio only if build succeeded?	visual-studio
"Can I write to the Test Results window ""Error Message"" field without failing a test?"	visual-studio
How do I enter a DateTime value in the VS QuickWatch window?	visual-studio
How do I get the assembler output from a C file in VS2005	visual-studio
Updating the version number of all assemblies in a solution	visual-studio
VS2008: Launching the executable for a project that isn't the active project in a solution	visual-studio
most efficient way to cut/paste in visualstudio	visual-studio
How do I refresh the relationships in a dataset?	visual-studio
Good Way to Debug Visual Studio Designer Errors	visual-studio
how to generate multi part assembly ( per folder) in visual studio for custom library project , C#?	visual-studio
What is the shorcut in visual studio to switch from code behind to Xaml Code ?	visual-studio
Best type of Visual Studio project for a simple collection of files?	visual-studio
Help documenting Javascript in Visual Studio?	visual-studio
Change background color of Solution Explorer in Visual Studio	visual-studio
How do I apply a set of properties to a subset of files in a Visual Studio Project?	visual-studio
"Visual Studio Addin - ""file in zombie state"" error"	visual-studio
Combo Box Item comparison and compiler warnings	visual-studio
Is there a way to conditionally run Visual Studio Post Build Steps	visual-studio
How to get cmd line build command for VS solution?	visual-studio
Cannot Access http://<tfs-server>:8080	visual-studio
How do I write a custom start page for VS 2008?	visual-studio
Programming on the Asus EEE Pc in Visual Studio	visual-studio
Visual Studio Express any good ?	visual-studio
Good techniques to use Makefiles in VisualStudio?	visual-studio
How do you move visual studio DataTip window	visual-studio
How to add Windows Mobile 6.1 image to VS 2008 Device Emulator Manager ?	visual-studio
How to delete files in Visual Studio Pre-build event command line	visual-studio
Resolving resx references	visual-studio
Ability to set the font to italics in Visual Studio	visual-studio
Best way to do Visual Studio post build deployment in a team environment?	visual-studio
How do I merge two different Visual Studio solutions?	visual-studio
Quick way to insert interface methods to a class in Visual Studio 2005	visual-studio
How to programmatically cancel an embedded MsBuild build	visual-studio
MSDN links in Visual Studio	visual-studio
How do you stop a Visual Studio generated web service proxy class from encoding?	visual-studio
Visual Studio project is placing object files in unrelated project directory. help.	visual-studio
What plugin would you really like to have for Visual Studio 2005/2008	visual-studio
How to assign keyboard shortcut to Source Control commands in Visual Studio 2008?	visual-studio
Finding references in Visual Studio	visual-studio
Are there reasons to use Visual Studio 2005 when 2008 is available?	visual-studio
Visual Studio opens default browser instead of IE	visual-studio
A project with output type of class library cannot be started directly - with a startup exe	visual-studio
How to get Visual Studio External Tools to use a currently open instance of the external tool?	visual-studio
VS2008 Windows Form Designer does not like my control.	visual-studio
Visual Studio Solutions / Multiple project : How to effectively propagate project properties amongst several projects	visual-studio
Unmanged x64 assemblies in mixed .NET development environment	visual-studio
Interpreting Visual Studio 2005 Threads Window	visual-studio
Visual Studio	visual-studio
Chanigng path for custom build step	visual-studio
In the Visual Studio SQL editor, how do I get rid of the boxes?	visual-studio
How To Prevent Tab Hell With Visual Studio And FireFox Debugging?	visual-studio
Is there a tool to convert a .vim colour definition file to use in VS.NET 2008	visual-studio
How to heighlight occurences of a search term in text in Visual Studio?	visual-studio
Source Control in Visual Studio Isolated Shell	visual-studio
FxCop on build (Visual Studio 2008 Professional)	visual-studio
VS 2k8 Doesn't Release File Handle After Debugging Stops: Unable to copy file X to output directory because it is being used by another process.	visual-studio
How to generate getters and setters in Visual Studio?	visual-studio
How can I clear the Warnings sections of the error list In VS2008?	visual-studio
Do Visual Studio 2005 testing tools contain tools for mocking?	visual-studio
Mysterious cosmetic Visual Studio Editor issue	visual-studio
Collapse all Visual Studio toolbox regions shortcut	visual-studio
"Visual Studio 2005: Please stop opening my CS files in ""Design Mode""!"	visual-studio
Why does Visual Studio 2005/2008 keep 'forgetting' to color code and format?	visual-studio
What could cause Visual Studio / C# error MSB3105: Duplicate resources	visual-studio
"Visual Studios Link.exe error: ""extra operand"""	visual-studio
Build won't copy System.Drawing to output folder.	visual-studio
"How can I use the ""Publish"" function in Visual Studio 2008 without erasing the contents of the target folder?"	visual-studio
Continuous Integration	visual-studio
How do I determine which service pack Visual Studio is running?	visual-studio
How to make Visual Studio take automatic actions on check-in?	visual-studio
Finding errors / warnings in Visual Studio	visual-studio
Setting both Debug and Release settings in Visual C++ 2008	visual-studio
Refactoring plug-in for Visual Studio 2003	visual-studio
Can you set VS2008 to break on an error inside a try-catch statement	visual-studio
Any way to keep myself from accidentally building in the wrong Visual Studio configuration?	visual-studio
Is there a standard keyboard shortcut to build the current project in Visual Studio?	visual-studio
How can I test for an expected exception with a specific exception message in Visual Studio Test?	visual-studio
Visual basic auto imports namespaces	visual-studio
How can I point Visual Studio 2008 to a new path for projects?	visual-studio
Would ReadyBoost have an impact on Visual Studio 2008?	visual-studio
Visual Studio (2008) mixed mode project depencies. C-sharp project depends on C++ dll, but C++ dll is not getting re-built	visual-studio
Visual Studio, MS Build	visual-studio
Automatic tracking of build number in VS 2005?	visual-studio
How do you use the immediate window in Visual Studio?	visual-studio
Programatically enforce capitalization in Visual Studio 2008?	visual-studio
Visual Studio Vs Visual Web Developer	visual-studio
Does Visual Studio have anything like Borland's CodeGuard?	visual-studio
What is the single best resource for learning the visual studio tools?	visual-studio
Visual Studio 2008 Syntax Coloring Problem	visual-studio
How can I make Visual Studio wrap lines at 80 characters?	visual-studio
ReportViewer displaying black background in Print Layout mode	visual-studio
Why do my exception stack traces always point to the last method line?	visual-studio
Visual Studio Solutions Folder as real Folders	visual-studio
Visual Studio 6 Processor Pack compatibility	visual-studio
Visual Studio Performance with External Hard Drive	visual-studio
What does the EXE do in the Visual Studio setup project output	visual-studio
Tablet PC SDK (1.7) Merge Module + VS2008 + Windows Vista?	visual-studio
Are there any Jira plugins for Visual Studio?	visual-studio
What are Microsoft's public symbol servers useful for?	visual-studio
Using Makefile instead of Solution/Project files under Visual Studio (2005)	visual-studio
Visual Studio to Make	visual-studio
How to create XML/XSD equivalent of a DataSet or DataTable in VS2008 (or other tool)	visual-studio
ASP.NET MVC Development tool	visual-studio
Missing Visual Studio features when running in 64-bit mode	visual-studio
What messaging/communication programs can be embedded into Visual Studio?	visual-studio
Unable to open the Web site: http://.. Forbidden	visual-studio
Visual Stuido: Make view code default	visual-studio
How to get rid of VSMacros80 folder from project root?	visual-studio
VisualStudio immediate window command for Clear All	visual-studio
How do I configure visual studio to use the code view as the default view for Webservices?	visual-studio
Any suggestions for effectively testing AJAX enabled web pages using MSVS Tester Edition Tools?	visual-studio
Developers with VS 2005 and VS 2008 working on the same project(s)	visual-studio
Editing SQL query with Visual Studio 2008	visual-studio
Folders or Projects in a Visual Studio Solution?	visual-studio
Custom Build Numbering in Visual Studio	visual-studio
Compiling code on an external drive	visual-studio
Visual Studio: Stop copying DLL files during build without my permission!	visual-studio
Is there any best practices for Visual Studio Project/Solution Structure?	visual-studio
Using Visual Studio 2005 with ClearCase Eclipsed Files	visual-studio
Visual Studio color settings for better eye	visual-studio
Visual Studio reference x64 GAC	visual-studio
In Visual Studio how to give relative path of a .lib file in project properties	visual-studio
MIDL generates the same file for /env win32 and /env win64	visual-studio
Why is Visual C++ lacking refactor functionality?	visual-studio
XML Comments: To Use or Not To Use?	visual-studio
How to change Visual Studio Auto Format	visual-studio
How do I prevent Visual Studio from renaming my controls?	visual-studio
Visual Studio 2010 SP1 to 11 Beta - Unit Test Project Cannot be Loaded	visual-studio
numericupdown control	visual-studio
"Drag and drop .cs files not using ""Add As Link"" in Visual Studio"	visual-studio
Should the new MFC Feature pack contols appear in VS toolbox	visual-studio
What's required for a clean uninstall of Visual Studio 2005	visual-studio
"Enable/Disable ""Step into"" debugging on certain project in visual studio solution"	visual-studio
VS Intellisense: can you hide extension methods?	visual-studio
stringstream manipulators & vstudio 2003	visual-studio
API/Framework to generate Visual Studio solutions/projects	visual-studio
How do you manage .vcproj files in souce control which are changed by multiple developers?	visual-studio
How do I keep Resharper Files out of SVN?	visual-studio
Tool in Visual Studio 2008 for helping with Localization	visual-studio
How to make file show when opening Visual Studio solution	visual-studio
Commonclipse for Visual Studio?	visual-studio
Visual Studio code formatting	visual-studio
Highlight user-specified words in Visual Studio?	visual-studio
DLL versions and Visual Studio attach to process	visual-studio
How to make document tabs in Visual Studio 2008 appear in left-to-right order, just as it was in earlier VS?	visual-studio
Customizing dockable windows in Visual Studio	visual-studio
Visual Studio solutions, do you nest them?	visual-studio
How to order variables alphabetically (Visual Studio 2008)	visual-studio
