text	label
Simple Type Inference in Scala	scala
Scala do I have to convert to a Seq when creating a collection from an iterable?	scala
A generic quicksort in Scala	scala
Why does scala immutable HashMap methods return a Map?	scala
How to instantiate an instance of type represented by type parameter in Scala	scala
Scala: Can't catch exception thrown inside a closure	scala
Singleton Scala actor?	scala
Scala compiler error passing null?	scala
Can you return an assignable lvalue in Scala?	scala
What is the purpose of type ascription in Scala?	scala
How can I construct and parse a JSON string in Scala / Lift	scala
Is there syntactic sugar for binding a value inside an anonymous function in Scala?	scala
Convert a List of Options to an Option of List using Scalaz	scala
What are the features of dynamic languages (like Ruby or Clojure) which you are missing in Scala?	scala
How to add external library to the classpath in scala's interpreter?	scala
What’s the difference between ScalaTest and Scala Specs unit test frameworks?	scala
How to get Enumeration  Value's Enumeration definition?	scala
Compile scala classes with debug info through Maven	scala
"How to unimport String ""+"" operator in Scala?"	scala
Scala array initialization	scala
Equivalent of public static final fields in Scala	scala
What is Lift's state idiom?	scala
Java SortedMap to Scala TreeMap	scala
Functional Reactive Programming in Scala	scala
Scala regexps: how to return matches as array or list	scala
Should my Scala actors' properties be marked @volatile?	scala
Implicit parameter in Scalaz	scala
Can I ignore invalid XML character using Scala's builtin xml handlers?	scala
How to flatten a List of different types in Scala?	scala
Why is Clojure much faster than Scala on a recursive add function?	scala
How to make a Scala Applet whose Applet class is a singleton?	scala
Scala's Implementation of haskell last method	scala
Applying a function to a tuple in Scala	scala
Scala foreach strange behaviour	scala
Questions about Scala from a Rubyist	scala
Scala can't multiply java Doubles?	scala
Scala type system : basic type mismatch	scala
"What is/are the Scala way(s) to implement this Java ""byte[] to Hex"" class"	scala
How to create List from Range	scala
What is the difference between scala self-types and trait subclasses?	scala
Scala BigDecimal division	scala
scala: mixins depending on type of arguments	scala
Can I transform this asynchronous java network API into a monadic representation (or something else idiomatic)?	scala
Scala: How to combine parser combinators from different objects	scala
Thread monitoring for scala actors	scala
Compile Scala 2.8.x code with Apache Buildr	scala
Scala and Tomcat -> NoClassDefFound Stringbuilder?	scala
How is this case class match pattern working?	scala
Can a Scala program be compiled to run on any JVM, without having Scala installed on the given machine?	scala
How well does Scala Perform Comapred to Java?	scala
Scala: Mutable vs. Immutable Object Performance - OutOfMemoryError	scala
Can Scala survive without corporate backing?	scala
Using Scala Actors to create sth like a Pipeline	scala
Drop into interpreter during arbitrary scala code location	scala
"Scala: working around the ""illegal cyclic reference"""	scala
Catch all exceptions in Scala 2.8 RC1	scala
Groovy / Scala / Java under the hood	scala
Should I upgrade to Intellij Ultimate Edition?	scala
Does this Scala actor block when creating new actor in a handler?	scala
"""Arrays"" in Scala"	scala
How to use Java Collections.shuffle() on a Scala array?	scala
Why does Scala's semicolon inference fail here ?	scala
Can't access ResizableArray's protected method, swap, from subclass, ArrayBuffer?	scala
What is are differences between Int and Integer in Scala?	scala
"scala ""error: io error while decoding"" ""with utf-8"""	scala
Performing operations on (specifically how to add a List of) Long in Scala	scala
Scala Enumeration and readResolve	scala
How can I get XStream to output Scala lists nicely? Can I write a custom converter?	scala
Scala actors as single-threaded queues	scala
"How to access ""overridden"" inner class in Scala?"	scala
Scala difference between object and class	scala
How can implicits with multiple inputs be used in Scala?	scala
Scala 2.8 return type for tuple-functions	scala
Scala vs. Groovy vs. Clojure	scala
Scala Tuple Deconstruction	scala
Scala implicit usage choices	scala
Proper way to access shared resource in Scala actors	scala
Using Java Lib with Scala Reserved Words	scala
Internal scala compilation. Working with interactive.Global	scala
Question on scala compiler syntax hacking	scala
Scala: How can I implement a clone method on a superclass, and use it in a subclass?	scala
Overloading generic implicit conversions	scala
Why does Scala have very little Enthusiasm about it?	scala
Scala Implicit convertions: 2 way to invoke	scala
a scala remote actor exception	scala
"Scala errors in Eclipse 3.5 using Scala 2.8.0b, ""Syntax error on token String"""	scala
scala Map: mysterious syntactic sugar?	scala
If scala scaled well for Twitter, would jruby have done the same?	scala
Why is flatten declared on GenericTraversableTemplate?	scala
In Scala, how to use Ordering[T] with List.min or List.max and keep code readable	scala
Generics and Constrained Polymorphism versus Subtyping	scala
Getting failure detail on failed scala/maven/specs tests	scala
Iterators for mutable collections in Scala?	scala
Scala : reference is ambiguous (imported twice)	scala
How can I serialize (and later deserialize) a generic type in Scala?	scala
In Scala, what is the difference between using the `_` and using a named identifier?	scala
In Scala 2.8 collections, why was the Traversable type added above Iterable?	scala
"What makes Scala's ""operator overloading"" good, but C++'s bad?"	scala
Optional attribute values in MappedField	scala
"Object converting string into ""A"""	scala
Can you do Logic Programming in Scala?	scala
Scala TreeMap strangeness; implementing a reverse-order iterator	scala
String representation of objects as in Scala REPL	scala
Is pretty XStream serialization feasible with Scala?	scala
Cross product of 2 sets in Scala	scala
How do I form the union of scala SortedMaps?	scala
Project Euler 7 Scala Problem	scala
Scala: What is the difference between while(true) and loop?	scala
What is the best book for learning Scala for an experienced programmer?	scala
Symbols or Case Classes for sending messages to Scala Actors?	scala
Array in Scala 2.8 (beta)	scala
Use Scala to unit test Java?	scala
Real-world examples of Scala applications?	scala
Case classes with an upper type bound	scala
Scala: XML Whitespace Removal?	scala
Scala factorial on large numbers sometimes crashes and sometimes doesn't	scala
How can I get a Node adjacent to a unique Node using Scala?	scala
best scala idiom for find & return	scala
lift `??` construct and maven example	scala
Scalaz: request for use case	scala
How to play with Specs matchers in Scala REPL?	scala
How to pass a class object from Scala to Java?	scala
Scala: how to merge a collection of Maps	scala
Is there a built-in more elegant way of filtering-and-mapping a collection by element type?	scala
Avoiding implicit def ambiguity in Scala	scala
Scala println in a for loop	scala
Strange GC behaviour of scala actors application	scala
This seems awfully repetitious for Scala...	scala
What the meaning of colon, underscore and star in lift's Sitemap(entries:_*) ?	scala
instantiate object with reflection using constructor arguments	scala
Are there any methods included in Scala to convert tuples to lists?	scala
"What does ""trait A <: B"" mean?"	scala
Scala abstract type bounds cross referencing	scala
Why can't Scala infer the type parameter in this example?	scala
How do I list all files in a subdirectory in scala?	scala
trait implementation	scala
depp copy of 2D array in scala?	scala
Is there a way to control which implicit conversion will be the default used?	scala
Scala syntax - pass string to object	scala
Closures and universal quantification	scala
Convert Scala Set into Java (java.util.Set)?	scala
Tuple parameter declaration and assignment oddity	scala
lazy loading some config params, trying to come up with a pattern in Scala...	scala
Implementing a java interface in Scala	scala
"Any reason for having ""val capacity : Int"" instead of ""val Int Capacity"" in Scala"	scala
Executing same piece of code for multiple case values?	scala
Need opinion regarding design/architecture of a web application	scala
Scala Actors suspends unexpected when connecting to a database	scala
What is the best way to format a string in Scala?	scala
Is there a nice, safe, quick way to write an InputStream to a File in Scala?	scala
Best way to select the id of the matching row with the most recent timestamp	oracle
Converting between oracle.sql.TIMESTAMPTZ and standard JDBC classes for DbUnit	oracle
Confusion over class resolution in Oracle java stored procedures	oracle
Dump Oracle table(s) data to INSERT statements	oracle
"Is there any way to programmatically ""move"" an oracle table definition from one database to another?"	oracle
Using a ref cursor as input type with ODP.NET	oracle
How do I bring an Oracle BLOB into SQL Server?	oracle
What is the fastest way to load data into a ORACLE database with .NET?	oracle
Oracle .NET error - Wrong number or type of arguments	oracle
Get resultset from oracle stored procedure	oracle
Detecting a column with a default value using the Oracle Call Interface (OCI)	oracle
Oracle 9i: How can I determine, using metadata, whether or not an index is clustered?	oracle
Oracle adds NULL Byte (ASCII: 0) to varchar2 string	oracle
How do you strip leading spaces in Oracle?	oracle
Too many columns in a single database table?	oracle
Oracle, deleting many records with child tables	oracle
PL/SQL function to return string with regexp special chars escaped	oracle
CREATE TABLE reverse engineering in Oracle	oracle
Best way in Oracle to go from this data to this result	oracle
oracle on port 8080	oracle
Oracle Check Constraint	oracle
How to determine the Schemas inside an Oracle Data Pump Export file.	oracle
Oracle: How can I programmatically arrange to have my current connection killed?	oracle
Possible to create Oracle Database object types inside of PL/SQL?	oracle
NLS_LANG setting for JDBC thin driver?	oracle
What is the difference between Views and Materialized Views in Oracle?	oracle
Meaning of (+) in SQL queries	oracle
alternatives for loading into oracle	oracle
Difference between two queries when selecting a random sample from oracle	oracle
What is the bullet-proof way to specify the Easy Connect string for Oracle?	oracle
Inserting into Oracle the wrong way - how to deal with it?	oracle
Oracle packages in version control?	oracle
passing a datatable as a field from Oracle to .NET	oracle
Oracle linux front end	oracle
Delete an oracle-user with single quotes in the username	oracle
When are two columns that look the same not the same in oracle?	oracle
What kind of import capability does Primavera support?	oracle
How to use SQLab Xpert Tuning to tune SQL for better performance?	oracle
Oracle V$OSSTAT	oracle
When I call PreparedStatement.cancel() in a JDBC application, does it actually kill it in an Oracle database?	oracle
databases oracle	oracle
How to install Java class on Oracle on Solaris	oracle
Things to watch out for in moving from Oracle Express to the Real Deal?	oracle
How to check if a trigger is invalid?	oracle
Oracle V-Limits (VARCHAR, VARRAY, etc)	oracle
DESCRIBE via database link?	oracle
How do I use oracle.jdbc.driver.OracleLog to debug Oracle 10g database connection failures?	oracle
How do I calculate tables size in Oracle	oracle
duplicate rows in oracle	oracle
Calculating person's time zone (GMT offset) based on phone number?	oracle
Diagnostic output of the Oracle Query Optimizer	oracle
"Mixing ""USING"" and ""ON"" in Oracle ANSI join"	oracle
Is Oracle BC4J Still Supported?	oracle
Serialize Oracle row to XML	oracle
Oracle ORA-00600	oracle
Oracle command-line tools on Linux	oracle
Oracle Syntax for Creating Database Link Owned by Another User	oracle
Slow deletes from table with CLOB fields in Oracle 10g	oracle
Oracle Scheduled Jobs	oracle
How can I use the 'NVL' function on a result table?	oracle
RowNum vs Row_Number	oracle
Oracle Update Hangs	oracle
How to write a SQL Loader control file to load data into multiple tables	oracle
Are there any .NET data providers for Oracle that do not require the Oracle Client to be installed?	oracle
"Oracle: what is the ""instantclient"" connection string format?"	oracle
How to determine the version of oc4j being used?	oracle
Changing a column in oracle that has a foreign key constraint	oracle
Oracle - How to grant to a user the rights to another user's objects	oracle
Oracle - Select where field has lowercase characters	oracle
Best way to encapsulate complex Oracle PL/SQL cursor logic as a view?	oracle
Does Oracle Applications API expose Web Services? (that can be called from .NET?)	oracle
what is d2k in oracle	oracle
Find all Foreign Key errors with Oracle SET CONSTRAINTS ALL DEFERRED	oracle
Oracle dbms_scheduler - react to change of system date	oracle
Allow Oracle User to connect from one IP address only	oracle
Oracle: how to add a text node into an existing element	oracle
Querying Oracle with a pick list	oracle
Oracle SQL Invalid Identifier	oracle
How to constrain a database table so only one row can have a particular value in a column?	oracle
Will Oracle optimizer use multiple Hints in the same SELECT?	oracle
oracle varchar to number	oracle
Oracle correlated subquery in FROM list	oracle
Why does Oracle 9i treat an empty string as NULL?	oracle
JVM crashes when trying to connect to Oracle using OCI	oracle
Oracle table change monitor	oracle
How can I change the SID or an Oracle XE instance.	oracle
Converting small-ish Oracle long raw values to other types	oracle
Oracle: How to create an element in a specific namespace with XMLElement()	oracle
What is the difference between Explicit and inplicit cursors in Oracle?	oracle
TOAD vs AquaFold - Connecting to Oracle	oracle
Tool for translation of Oracle PL/SQL into Postgresql PL/pgSQL	oracle
Oracle SYS_GUID does not change	oracle
Oracle Sequences	oracle
Is it possible to refer to column names via bind variables in Oracle?	oracle
dba_jobs_running: table or view does not exist when trying to access from procedure	oracle
Export Oracle user tables to MS Access automaticaly	oracle
Oracle - OCI query timeout	oracle
Is there an easy way to clone the structure of a table in Oracle?	oracle
Oracle - How does transaction, rollback segment and the undo_retention parameter work ?	oracle
ORA-27101: shared memory realm does not exist in Oracle 9	oracle
How to determine a PL/SQL function's schema from within the function	oracle
In Oracle, why do public synonyms become invalid when a table partition is dropped.	oracle
PL/SQL Evaluation Order	oracle
Replace (translate) one char to many	oracle
Reasonable SELECT ... INTO Oracle solution for case of multiple OR no rows	oracle
Performance of Oracle .Net drivers	oracle
How to set session variable skip_unusable_indexes to true in a PL/SQL package to speed up a table delete/insert?	oracle
Are there alternative methods for saying 'next' in a pl/sql for loop?	oracle
Choosing a desktop database	oracle
Assign auto-incrementing value to new column in Oracle	oracle
Does Oracle allow an ORDER BY within an IN clause?	oracle
Exporting Excel Data into Oracle Table using VB.NET	oracle
Oracle merge constants into single table	oracle
Hom to change default nls_date_format for oracle jdbc client	oracle
Add date without exceeding a month.	oracle
Oracle: How do I convert hex to decimal in Oracle SQL?	oracle
What is the best approach for decoupled database design in terms of data sharing?	oracle
how to change a column's attribute without affecting the values already present?	oracle
Optimizations for a Write heavy Oracle application?	oracle
Improve oracle query performance without indexing	oracle
ODP.net Oracle Decimal Number precision problem when filling a dataset. Exception: Arithmetic operation resulted in an overflow	oracle
Why do you hate sequences on Oracle?	oracle
Cannot Connect with TOAD but Can with Other Tools/Apps	oracle
Dynamically look up column names for a table while in an sql query	oracle
Can an Oracle variable of type RECORD be passed between procedures without the procedures knowing its real type?	oracle
SQL Developer error	oracle
Can Multiple Indexes Work Together?	oracle
Why does Oracle think I'm missing a right parenthesis?	oracle
How can I find which tables reference a given table in Oracle SQL Developer?	oracle
What column type in Oracle can take full range of java double values	oracle
Finding correlated values from second table without resorting to PL/SQL	oracle
Restore and Recovery Scenario	oracle
Oracle XE for Linux...?	oracle
Bulk Row Transfer between Oracle Databases with a Select Filter	oracle
Is there an easy way to backup Oracle SQL Developer's User Snippets?	oracle
Oracle 11g Cold Restore?	oracle
Oracle EXECUTE IMMEDIATE with variable number of binds possible?	oracle
Can I get ORA-08177 if there's only one connection to the database?	oracle
Best solution for Java web based forms connected to Oracle plus JNI?	oracle
Oracle Default Values	oracle
how to use a procedure parameter in a query	oracle
Oracle Analytic Question	oracle
Using Semicolons in Oracle SQL Statements	oracle
How to tranform an Oracle SQL into a Stored Procedure that should iterate through some tables fetching a certain data field?	oracle
How do I let my DBA pause and resume a stored procedure that is updating every row in a large table?	oracle
Oracle 9i: Synonymed Table Does Not Exist?	oracle
Oracle TIMESTAMP WITH TIMEZONE named zone vs offset	oracle
Tools for matching name/address data	oracle
"""Pivoting"" a Table in SQL"	oracle
Using an Alias in a WHERE clause	oracle
Multiple @ManyToMany sets from one join table	hibernate
Hibernate: Why @OneToMany with List<MyClass> fails?	hibernate
Does Fluent-Hibernate exist?	hibernate
how to define an inverse cascade delete on a many-to-one mapping in hibernate	hibernate
Hibernate mappings with a descriminator	hibernate
How do I restore a transient field in Hibernate like readResolve() for hibernate serialization?	hibernate
Strategies to avoid Hibernate  LazyInitializationExceptions	hibernate
if hibernate can generate the db schema, how to tell it to create a column of nvarchar(max)?	hibernate
Hibernate: Clean collection's 2nd level cache while cascade delete items	hibernate
Problem with sorting on child object in Hibernate when order-by is present in .hbm files ?	hibernate
Issue with serializing Hibernate objects using XStream	hibernate
Hibernate - Avoiding unnecessary join when using foreign key in where close	hibernate
Hibernate Oracle and Character Encoding	hibernate
Hibernate 2nd level cache objects that are lazy=false, result in a default fetch=join, is it documented anywhere?	hibernate
Hibernate 2nd level cache not caching committed entities	hibernate
Hibernate JPA Template fetch	hibernate
Combo boxes with Hibernate	hibernate
@OneToMany without inverse relationship and without a join table?	hibernate
Elegant way to handle upsert with Hibernate and MySQL	hibernate
Getting the return value of a PL/SQL function via Hibernate	hibernate
Hibernate Query vs Criteria Performance	hibernate
Hibernate mapping inheritance	hibernate
Problems with ArrayList items and hibernate	hibernate
Problem in using indexes with SQL Server 2005 and Hibernate	hibernate
Cast function for Hibernate	hibernate
Hibernate - @ManyToMany with additional fields in mapping entity	hibernate
Value of 0 in Hibernate IndexColumn mapped with base=1	hibernate
Best practice to return a result Flag after saveOrUpdate in hibernate ?	hibernate
Hibernate queries slow down drastically after an entity is loaded in the session	hibernate
Self-referencing updates in HQL	hibernate
"""Session closed"" error when trying to get a blob from DB using getBinaryStream()"	hibernate
Hibernate polymorphism: instantiating the right class	hibernate
Lazy loading...	hibernate
Hibernate mapping collection by column	hibernate
schema2ddl generates wrong datatype for YesNoType	hibernate
How to map inner object using Hibernate/JPA without xml/annotation?	hibernate
Hibernate ManyToOne relation to a joined subclass type	hibernate
How to limit fetching of entities from SQL query.	hibernate
Hibernate set mapped to a 'sql select' table	hibernate
How to query distinct values from map with given key in Hibernate?	hibernate
hibernate lazy solution. Is it right??	hibernate
WAS 6.1, Hibernate, Spring and transaction managmement configuration	hibernate
hibernate and spring persistance problem.  Possible identity value not incremented?	hibernate
Transactional L2 cache in Hibernate	hibernate
Hibernate query by example (from Spring 3)	hibernate
Hibernate 2nd level cache invalidation when another process modifies the database	hibernate
How can I remove an item from a Hashmap in Hibernate ?	hibernate
Limit associated entities loaded through a Hibernate Criteria	hibernate
Why are people continuing to use xml mapping files instead of annotations?	hibernate
understanding hibernate first level cache	hibernate
hibernate deletion problem please help urgent	hibernate
Is it possible to load an object, it transient state from the get go?	hibernate
Hibernate not reflecting changes	hibernate
hibernate - uniqueResult silently fails	hibernate
hibernate property formula how 2 get more than 1 row?	hibernate
Why do associated collections contain null values? (Hibernate, Annotation, Spring)	hibernate
Mapping a Natural Key with Hibernate Annotations	hibernate
Hibernate Entity sort column configuration	hibernate
Hibernate not fetching public member	hibernate
how to insert record in join table of many to many  hibernate annotation	hibernate
Modelling a temporal-style relational table in Hibernate	hibernate
"""SELECT ... FOR UPDATE"" not working for Hibernate and MySQL"	hibernate
Hibernate Computed Criteria Order	hibernate
Hibernate: Foreign key has the wrong number of columns	hibernate
Hibernate NullPointerException In Loader Class	hibernate
How do I map a nested collection, Map<Key,List<Values>>, with hibernate JPA annotations?	hibernate
Hibernate SessionFactory	hibernate
how to add fields dynamically  when using hibernate	hibernate
hibernate ehcache only finding 1 element of a collection	hibernate
Using Maven in Hibernate Tutorial	hibernate
hibernate composite key	hibernate
Hibernate on Oracle: mapping String property to CLOB column	hibernate
Design pattern for translatable Hibernate models	hibernate
cannot do 2nd level cache	hibernate
image upload problem	hibernate
Hibernate creates two primary keys when I only want one...	hibernate
Using Restrictions.disjunction over @JoinTable association	hibernate
How to join tables in unidirectional many-to-one condition ?	hibernate
How do I implement toString() in a class that is mapped with Hibernate?	hibernate
Hibernaqte exception :org.hibernate.exception.SQLGrammarException: could not execute query	hibernate
Hibernate HQL: two levels of joins	hibernate
commandline equivalent to reverse engineering in Hibernate tools?	hibernate
@ManyToMany Hibernate Question (can add extra field?)	hibernate
NHibernate one-to-many relationship lazy loading when already loaded	hibernate
org.hibernate.HibernateException: No session currently bound to execution context	hibernate
How can Hibernate map the SQL data-type nvarchar(max)?	hibernate
Hibernate HQL with interfaces	hibernate
Elegant ways to handle database views on hibernate entities?	hibernate
hibernate not using where clause with inner join	hibernate
Hibernate + EhCache, keep missing the cache	hibernate
how to create hbm files from java files??	hibernate
Hibernate: More than one relationship using the same join column	hibernate
Hibernate Specific DDL Generation	hibernate
Hibernate transaction boundaries	hibernate
Hibernate session / transaction design	hibernate
Does Hibernate 2nd-Level cache invalidate when running a JPQL update statement	hibernate
@Immutable vs @Entity(mutable=false) in Hibernate	hibernate
Implementing result paging in hibernate	hibernate
Constraint error in hibernate	hibernate
many-to-many JPA mapping inserting but not fething the child collections	hibernate
Hibernate 2nd lvl cache	hibernate
Getting my webapp to be database agnostic with Hibernate...	hibernate
HQL Query using group by	hibernate
Hibernate - query caching/second level cache does not work by value object containing subitems	hibernate
Hibernate entity with user defined attributes	hibernate
Is there a good reason to configure hibernate with XML rather than via annotations?	hibernate
How to create a hibernate idbag with a collection-id that has a default value?	hibernate
Spring Hibernates session issue with http request	hibernate
Can I specify a hibernate relationship with a filter?	hibernate
hibernate - delete hql in eclipse hibernate tool	hibernate
INSERT LOW_PRIORITY or INSERT DELAYED in Hibernate	hibernate
hibernate workflow	hibernate
Hibernate hql problem using case keyword	hibernate
why does hibernate not force you to mark fields as virtual, but nhibernate does?	hibernate
HQL 1 to many count() question	hibernate
Hibernate: Parse/Translate HQL FROM part to get pairs class alias, class name	hibernate
Hibernate detached queries as a part of the criteria query	hibernate
Getting hibernate to log clob parameters	hibernate
Hibernate Self Join	hibernate
Map database column1, column2, columnN to a collection of elements	hibernate
Hibernate MySQL transaction configuration issue	hibernate
hibernate connection pool	hibernate
Hibernate Oracle Tablespace Annotation	hibernate
Which pattern does Hibernate follow?	hibernate
Hibernate Query that Orders an Attribute based on a nested path.	hibernate
Ids not available from proxy object	hibernate
Hibernate Security Apprehension: Hibernate vs. Stored Procedures	hibernate
define name query in orm.xml with jpa and hibernate	hibernate
Understanding hibernate internals	hibernate
hibernate session error	hibernate
Using Hibernate/JPA without relationships and avoiding multiple DB calls	hibernate
Breaking up a large Hibernate class	hibernate
Can't create foreign key	hibernate
Hibernate many to one delets all parents when a child is deleted	hibernate
Why hibernate session.close() does not flushes the data automatically?	hibernate
Detached Objects in Jdo/Hibernate - What are they for anyway?	hibernate
Spring hibernate query help	hibernate
How to setup Hibernate @ManyToMany association with cascades on both foreign keys?	hibernate
What are good video tutorials for Hibernate ?	hibernate
Hibernate + Spring + persist one-to-one relation + empty foreign key	hibernate
How to add a Hibernate property that's really a query	hibernate
Hibernate, save the previous state of an object	hibernate
Hibernate ordering	hibernate
Using Hibernate sequence generators manually	hibernate
Help with Hibernate Collection Foreign Key Mapping	hibernate
Connection hangs after time of inactivity	hibernate
hibernate Open Session in View	hibernate
Hibernate: batch_size? Second Level Cache ?	hibernate
Table not created by Hibernate	hibernate
Not able to save composite foreign key	hibernate
Fetch iTunes album artwork without iTunes running	cocoa
Mac OS X: Quickest way to kill/quit an entire process tree from within a Cocoa application.	cocoa
How do I localise a default attribute in a Core Data Entity	cocoa
Disable NSToolbar customisation via window's toolbar button?	cocoa
When does selectedCell change?	cocoa
Graphic effects library for Core Graphics?	cocoa
Getting rid of the focus rect on an NSCell. Only shows up when right clicking.	cocoa
Parsing XML in Cocoa	cocoa
How to get notifications of NSView isHidden changes?	cocoa
getting the path of a application at runtime + cocoa	cocoa
"Any ""fundamentals-oriented"" example of NSScroller out there?"	cocoa
How best to debug a crash within objc_msgSend?	cocoa
Triggering a method when a row in a Table View is edited.	cocoa
Using NSPredicate to filter an NSArray based on NSDictionary keys	cocoa
How do you read a third-party Cocoa project?	cocoa
Receiving keyDown and keyUp events in a Cocoa Status Bar app	cocoa
NSTableView selection & highlights	cocoa
[self arguments] in NSScriptCommand	cocoa
Comparing Two Arrays.	cocoa
How do I save state with CALayers?	cocoa
Using NSTask: app freezing after returning output	cocoa
NSString to wchar_t*?	cocoa
Cocoa without Interface Builder, initialize an instance of app controller?	cocoa
Dynamic Results and Covering Data	cocoa
How do you develop an application to draw, edit and save UML models in Cocoa?	cocoa
Cocoa development: malloc: free_garbage: garbage ptr = 0x18a15e0, has non-zero refcount = 1 error	cocoa
Bottom bar in NSWindow	cocoa
Correct Structure to check for Errors using NSError	cocoa
Disable Option-Enter line breaks in NSTextField?	cocoa
Adding a subview below my UITableView	cocoa
iPhone subview design (UIView vs UIViewController)	cocoa
"How does Apple make the info.plist display its ""Information Property List""?"	cocoa
Using predicates on an array controller to filter related objects	cocoa
What is the most elegant way to encode/decode an Object to Dictionary	cocoa
Helper functions in Cocoa	cocoa
NSMatrix and autoresize only certain cells?	cocoa
How can I divide a bound array in parts that automatically fill the table?	cocoa
"Add app to the ""Startup Items"""	cocoa
Fetching Core Data entities, but not sub-entities	cocoa
Memory Leaks - Formatting a String To Display Time, Each Second	cocoa
Is it possible to bind the null placeholder in Cocoa?	cocoa
How to have an NSMenu with dynamic actions	cocoa
What are alternatives to Objective-C for Mac programming?	cocoa
How to do a full text search in Cocoa?	cocoa
NSTask returning HTTP Headers	cocoa
What is the reason for NSFileManager's inconsistent use of NSURL?	cocoa
How to use native C types with performSelectorOnMainThread:?	cocoa
NSPredicate case-insensitive matching on to-many relationship	cocoa
Making an NSButton In-Active.	cocoa
Mac libraries for audio processing/sound file splitting	cocoa
How do you flip the coordinate system of an NSView?	cocoa
How to change style for nodes in NSOutlineView?	cocoa
Background image for a window in cocoA framework	cocoa
How to determine if currency symbol is to the left or right of a number on MacOS	cocoa
"Cocoa Distributed Objects, Long Polling, lunchd and ""Not Responding"" in Activity Monitor"	cocoa
Gray NSTableView à la iTunes	cocoa
How do you make a Outline View Re-Orderable like a Table View?	cocoa
How to use NSURLRequest with non-static content?	cocoa
Cocoa - Communication from child view to parent view	cocoa
How to get NSImage of generic folder icon on OS X 10.5 and 10.6	cocoa
CheckBox in tableview	cocoa
Remove newline character from first line of NSString	cocoa
How to hide the Dock icon	cocoa
How to customize NSTextField look (Font used, font size) in Cocoa ?	cocoa
NSTask and which not finding my installed git location	cocoa
In-memory mime-type detection with Cocoa (OS X)?	cocoa
Preferences Window Problem (Once Open And Closed, Will Not Open Again)	cocoa
Change File Save Location	cocoa
Why can't I select symbolic links in NSOpenPanel?	cocoa
How do I dispose of my own sharedInstance in Objective-C?	cocoa
Best way to post NSNotification with NSRect info?	cocoa
How do I get each line from an NSString?	cocoa
Why are subviews of an NSView not sent a release message when a Cocoa application terminates?	cocoa
- (void) processImage:(char *)image;  ---char* causes a memory leak?	cocoa
How do you set a title so that every row in a table has the title already typed in when you add a new row?	cocoa
Cocoa: Learn currently selected keyboard layout / input language	cocoa
Giving The Root Row Of An Outline View A Different Background Color.	cocoa
SFAuthorizationView authorize: method does not work.	cocoa
NSDocument architecture pros and cons	cocoa
Cocoa Interface Builder's 'Attributes Inspector' like window	cocoa
On OS X, seperating a GUI into multiple NIB files and NSView subclasses	cocoa
Sort NSFileManager Results	cocoa
Writing a string to NSPasteBoard	cocoa
How do you make the Application window open when the dock icon is clicked?	cocoa
How to play a mp3 file from within the Ressources folder of my application ?	cocoa
Getting notified when the current application changes in Cococa	cocoa
How do I create NSColor instances that exactly match those in a Photoshop UI mockup?	cocoa
How to create a series of dates in Cocoa for a week	cocoa
Problem with WebKit rendering google.com (and a few other sites)	cocoa
resizing an NSPanel to fit a dynamic NSMatrix and a button	cocoa
Using Cocoa to detect when a running application plays audio	cocoa
How to use Mac OS X Cocoa events for multitouch gestures	cocoa
"How can I set a ""hidden"" attribute for text inside NSAttributedString?"	cocoa
Cocoa/ Objective-C Shell Command Line Execution	cocoa
How can I get the icon for a storage device in Mac OS X?	cocoa
NSMutableArray memory management	cocoa
Esc and Enter keys in Cocoa dialog	cocoa
How do you make a row in a table view go slighly opaque if a checkbox in that row is checked?	cocoa
How to create an iPod-esque UISlider	cocoa
Suggested resources for learning about blocks in Snow Leopard	cocoa
What's the easiest way to create an array of structs?	cocoa
Dynamically hiding columns in a NSTableView	cocoa
How to get the token type from a CFStringTokenizer in Cocoa?	cocoa
What's the difference between a CoreAnimation Layer Backed View and a Layer Hosting View	cocoa
Mac OS X - System Preference Pane won't open	cocoa
Persist and rearrange the order of Core Data records	cocoa
Licensing Technology for OS X applications?	cocoa
Cocoa Core Data - Background Thread	cocoa
How can I access specific subsets of a large NSDictionary in Cocoa?	cocoa
"Implementing ""scrubby sliders"" in Cocoa?"	cocoa
Get current playing song using Cocoa	cocoa
What is the Cocoa equivalent of UpdateSystemActivity?	cocoa
setNeedsDisplay not working?	cocoa
Locating bundles by identifier	cocoa
How can I send a HTML email from Cocoa?	cocoa
Core Animation with a Core Graphics drawing	cocoa
Testing for writability of BSD socket in Cocoa.	cocoa
Avoiding, finding and removing memory leaks in Cocoa	cocoa
NSMutableArray count always returns zero	cocoa
In Cocoa/Interface Builder, how to clear text in textfield after button click	cocoa
Cocoa: What NSTextView the insertion point is currently blinking in?	cocoa
Cannot hide Controls in NSView	cocoa
What are the steps to creating an 'executable bundle'	cocoa
How to make a transparent NSView subclass handle mouse events?	cocoa
How do I get objects in the responder chain to handle `insertText:` messages?	cocoa
Changing NSApplicationIcon across a running application?	cocoa
How to programatically get current battery level with COCOA	cocoa
What leads to a no suitable image found error on Mac OS X?	cocoa
Retrieving All Of An NSTreeController's Objects.	cocoa
Property declaration for to-many fields in Core Data	cocoa
Trouble with Float in Objective-c	cocoa
Filtering A Tree Controller.	cocoa
Can you detect a ctrl-click (context menu) request in the mouseDown event?	cocoa
Cocoa -/+ declarations	cocoa
NSTableView switch column	cocoa
Storing a passwords in NSString without being readable in memory	cocoa
Is the file hidden?	cocoa
Code in NSTimer prevents automatic sleep	cocoa
Ordinal Weekday Suffix Option for NSDateFormatter setDateFormat	cocoa
How do I create an import-only document type in Cocoa?	cocoa
Creating a Quartz Composer Style interface	cocoa
Do NSShowAllViews and NSShowAllDrawing work with XCode 3, OS X 10.5.6 ?	cocoa
Core Data: Strange bindings error on re-opening a document. Help?	cocoa
Making a Checkbox Toggle The Dock Icon On and Off.	cocoa
Cocoa - Suggested techniques for debugging binding problems between XCode and Interface Builder	cocoa
Getting NSArrayController item for right click in NSCollectionView	cocoa
Wrap NSButton title	cocoa
how to search the file in  the next level of the mac root ?	cocoa
How to use Google Toolbox for Mac for UI unit testing.	cocoa
Tripping over NSValue, NSNumber & NSDecimalNumber	cocoa
"How to create a zip file in the same format as the Finder's ""Compress"" menu item?"	osx
Where can I go for hands-on cocoa training besides WDC?	osx
Finder item in some point	osx
Group by weekdays with Core Data	osx
Where are Java preferences stored on Mac OS X?	osx
Blank process name for OSX Cocoa application?	osx
Is JSCocoa safe for commercial Mac desktop applocations?	osx
How do I disable warnings being flagged as errors in XCode	osx
Mac Web Sharing Subdomains	osx
Find Mac OSX version installed using AppleScript	osx
Creating an empty txt file on Mac OS without opening an application first	osx
Firefox cache path construction Mac OS X	osx
What would you do instead of using NSViewController to be compatible with 10.4?	osx
Applet 1.6 on Mac OS X	osx
Remembering terminal states in OS X (like Fluid for the shell...)	osx
Mac os X : load average	osx
Using a Mac for crossplatform development?	osx
Find all PPC libraries, binaries and applications in Snow Leopard	osx
Porting .NET C++ standalone to Mac	osx
OSX: Launching multiple instances of an app and passing them command line args	osx
MySQL Install: ERROR: Failed to build gem native extension.	osx
Mac OS X / Good terminal template	osx
How to detect whether an OS/X application is already launched	osx
disabling color correction in quartz 2d	osx
How to Write OS X Finder plugin	osx
creating a .dll on a mac: .dylib or framework?	osx
Upload Folder via Mac Terminal	osx
Is it possible to add multiple commands to the readline .inputrc file?	osx
"Programatically trigger ""detect displays."""	osx
Is there anything like Winsplit Revolution for Mac OS X?	osx
Do you strip header files when shipping frameworks with your OSX application?	osx
"Is it possible to have PackageMaker build an installer without ""packaging"" the content at build time?"	osx
Getting a CGImage out of a PDF file	osx
Quartz display services replacement for deprecated functions?	osx
How to check for COMMAND key held down Java/SWT at startup on Mac OS X	osx
Compiling and installing pyactivemq on osx	osx
When using py2app, is there a way to customize the traceback dialog that gets displayed? (Or show a different Cocoa dialog?)	osx
Change background of Terminal.app from the commandline	osx
osx & windows development -- for newbies	osx
Restore app from dock	osx
Mac OS X New Users From Command Line	osx
Mac client can't resolve Windows Home Server name	osx
Possible to include Mono Runtimes in OSX .app bundle?	osx
Controlling OSX windows	osx
Terminal Command Mac Alter table SQLite3...	osx
Testing web application on Mac/Safari when I don't own a Mac	osx
How to pass an arbitrary AppleScript Record to Cocoa in a scriptable app?	osx
SVN resolve multiple files using bash/terminal on OS X	osx
MAC OSX, which version of MySQL should I download?	osx
Cannot connect to svn server (svnserve)	osx
drawing in other processes window on macosx?	osx
python 2.5 removal	osx
How do I determine file encoding in OSX?	osx
Installed git on OS X; What should I add to my PATH?	osx
Trying to get rsync to copy files back to svn	osx
How to share clipboard between tmux/vim and osx	osx
Mac OS. How to create PNG from array data?	osx
Unable to turn off automatic margins by termcap in Mac	osx
Multiple mice on OS X	osx
Eclipse RCP on OSX - How to stop logging to syslog?	osx
How do I select a file within a .app in Mac OS X?	osx
Mac OS web sharing and Django	osx
Launch safari from a Mac application	osx
Obtaining a Mac's System Profiler data from shell	osx
Getting a List of Applications Capable of Opening a Type of File	osx
FSEvent weirdness on Mac Leopard	osx
AppleScript for unlock screen dialog	osx
Mac dev - Help getting started with 2d games	osx
How do I get keyboard events in an NSStatusWindowLevel window while my application is not frontmost?	osx
Objective-C Asynchronous Web Request with Cookies	osx
Mac os help browser fails requiring internet connection	osx
Undefined symbol _main when trying to build logstalgia on mac	osx
When is a CGBitmapContext not a BitmapContext?	osx
Mac Pro 64-bit addressing kernel	osx
When to create Interface Builder plug-in for custom view?	osx
Is it possible to develop Mac OSX apps on Windows?	osx
MySQL InnoDB insertion is very slow	osx
Mac font rendering on Windows	osx
Console in Mac OpenGL application	osx
How do I execute a PHP shell script as an Automator action on Mac OS X	osx
Best Way To Get Started With Mac Development	osx
What software to use for virtual machine for Windows development?	osx
Offsite backup from a timemachine capsule	osx
Mac driver development	osx
Multiple calls with Simple Modal OSX Style Dialog	osx
lost library when recompiling Obj-C project	osx
unnecessary (?) Xcode warning	osx
File-level filesystem change notification in Mac OS X	osx
startup script fot Mac OS	osx
SharePoint Designer for Mac?	osx
MobileMe API Documentation	osx
OS/X mimetype handler	osx
Mac OS X. Switching between fullscreen and windowed mode.	osx
How do I get an RTSP stream to play in Mac OS X's Quartz Composer?	osx
How to see what label color is on a file/folder from within Termnal (Mac OS X)	osx
.NET Development on a Mac Tips	osx
Building universal binaries on Mac - Forcing single compiler child process	osx
link error when using boost library on MacOSX	osx
Bash Scripting General Questions (conditionals and variable passing)	osx
How to get the desktop resolution in Mac via Python?	osx
How to get NSAlert sheet to return focus to calling window?	osx
Programatically get/set Mac OSX default system keyboard shortcut	osx
Cross-Platform Objective-C / C++ Development	osx
How to I launch an on-screen keyboard from my application on Mac OSX?	osx
Alternative LAF to quaqua	osx
Setting up a one-time installer using Apple's PackageMaker	osx
Any pitfalls developing C#/.NET code in a Virtual Machine running on a MAC?	osx
Locking Your Own NSPreferencePane?	osx
Mail Message Link Handling	osx
NSTextView not refreshed properly on scrolling	osx
Disable/Cancel Sleep Command on MacOSX	osx
Bash prompt in OS X terminal broken	osx
Custom Class - IBOutlets Not Working?	osx
Determine a process's architecture	osx
Ejecting a hidden volume	osx
Help needed with F_NOCACHE in mac	osx
How do I get the name of the active user via the command line in OS X?	osx
Is it possible to create autorun hybrid CD/DVD on Max OSX Tiger/Leopard?	osx
Python - Virtualenv , python 3?	osx
How to pass a command line switch to XCode when I start 'Build and Debug'	osx
Mac Resource editor in Snow Leopard?	osx
Subversion on Mac - refuses to get password from keychain	osx
The logic behind MacOS's Exposé	osx
pbcopy does not seem to work within a gnu screen window in OSX	osx
Redirecting audio output	osx
libusb preferred method on mac os x to access usb device?	osx
Precompiled headers and compiling universal objects on OSX	osx
mac software development	osx
How to specify which GDB I can use in XCode on MacOS	osx
How do I get a list of the window titles on the Mac OSX?	osx
Is there non-daemon FTP server application fot Mac OS? (like MAMP)	osx
Mac Console paste generating trash text	osx
osx mysql gui with plain text output?	osx
How to compile a dynamic library?	osx
How do I know which OSBundleLibrary to include when using XCode?	osx
SVN won't commit unversioned files even though they show up with svn status	osx
how to get a window to receive drag and drop files in xcode	osx
Intercepting HTTP request on Mac OS X?	osx
How am I going to reproduce Javascript bugs if I don't have a Mac & Safari?	osx
Is it possible to send a growl message to another user on the same computer on OSX?	osx
Applet lifecycle in Mac OS X	osx
MacBook Trackpad Gestures: Move active Window	osx
Cocoa 10.5 multithread app runs slowly	osx
Feedback/Experiences with Monodevelop on the Mac?	osx
How to configure term on MacOSX with color	osx
OSX - Retrieve user id of logged-in user from a system service	osx
Drawing automatic graphs using dot in mac python	osx
Cocoa application crashing on OpenGL call	osx
Porting OpenGL Application to Mac OS: X11, Cocoa, or Another Alternative?	osx
Coding a Mac OS X terminal emulator?	osx
Removing contents of PlaceHolderPageTitleInTitleArea	sharepoint
"What does the ""ONET"" in ONET.xml stand for?"	sharepoint
Accessing SharePoint Web Services over Silverlight	sharepoint
Defaulting WebParts on a Users MySite in Sharepoint	sharepoint
Customizing breadcrumb in sharepoint publishing site with variations	sharepoint
Displaying a custom form on a new item event in SharePoint 3 document libraries?	sharepoint
Sharepoint updating custom database	sharepoint
SharePoint Infrastructure Upgrade - whoops	sharepoint
Program custom permission level	sharepoint
Sharepoint Blog: enable/disable comments regarding field value of Posts	sharepoint
Storing Feature Configuration within Sharepoint	sharepoint
How can I automate the process of deploying an InfoPath Form to SharePoint Server 2007?	sharepoint
How to get a SharePoint-UserField with JavaScript ?	sharepoint
How can commenting be added to news articles in an existing Sharepoint 2007 news site?	sharepoint
Using SPSite from 32bit application to access 64bit SharePoint	sharepoint
SharePoint: Error on unregistering an EventReceiver form a ContentType	sharepoint
How do I implement IWebPartField.Schema correctly when providing a string field	sharepoint
Create a SharePoint Survey from an Excel spreadsheet	sharepoint
Any way to get SharePoint to STOP converting attachment file names to all lower case on inbound emails?	sharepoint
SharePoint Lists, GetListItems, XML, and VBA - I just want to crossreference!	sharepoint
SharePoint Preserve Page Properties and WebParts	sharepoint
Setting up Alerts in SharePoint	sharepoint
CustomAction not appearing in ListView web part for SPList that does not inherit permissions	sharepoint
SharePoint 2007 Calendar - Remove Time	sharepoint
Are there design patterns for writing SharePoint workflows that will be upgradable?	sharepoint
Sharepoint SPDisposeCheck	sharepoint
Programmatically create SharePoint list	sharepoint
Sharepoint List View Settings	sharepoint
Sharepoint- Inserting in a list subfolder	sharepoint
Extending Sharepoint XSL template	sharepoint
Can I add object field to SPItem, to attach some kind of object to item?	sharepoint
Page Layout does not appear in the page layouts list	sharepoint
SharePoint API to get Crawling information	sharepoint
"VSeWSS ""Attach to IIS Worker Processes"" grayed out"	sharepoint
SharePoint Workflows - How to associate with specific content types (particularly folders)?	sharepoint
Is there a way to put get the URL of the site in creation in the ONET.XML file?	sharepoint
Adding presence indicator to a custom web part	sharepoint
Properly implement a webpart with postback?	sharepoint
"How to enable ""Connect to Outlook"" function in your custom list?"	sharepoint
Sharepoint - Providing data outisde intranet	sharepoint
Using a MulitpleLookupField in MOSS '07 Layout Page	sharepoint
MetaStorm Ework and SharePoint 2007	sharepoint
SharePoint branding of error pages	sharepoint
Is it possible to limit the lines of text displayed in a Sharepoint list view?	sharepoint
Getting a list of running workflows?	sharepoint
SPGridview single DataKeyName instead for multiple?	sharepoint
Update Item attribute in sharepoint using web services	sharepoint
how do i add a view to schema.xml in sharepoint	sharepoint
Unwanted SharePoint context menu	sharepoint
Check to see if Visual Studio can load an assembly	sharepoint
Programatically Publishing InfoPath Form As Site ContentType (Not Central Admin)	sharepoint
WebPart Connections on Sharepoint. - Which Type to use?	sharepoint
Howto: enable anonymous surveys in sharepoint	sharepoint
How to get notified about chnages on SharePoint groups.	sharepoint
combining diffirent lists data and showing it in a webpart	sharepoint
SharePoint Survey, Ask same question n times based on answer to previous question.	sharepoint
MOSS 2007: SPListItem.GetFormattedValue for DateTime fields has a bug?	sharepoint
Can a SharePoint list item have it's Targeted Audience calculated or otherwise automatically specified?	sharepoint
Required Fields in Share Point data collection not throwing errors	sharepoint
Microsoft Dynamic CRM integration SharePoint	sharepoint
data disappear after Item Update in Sharepoint with Office 2007 documents	sharepoint
Issus deleting a site collection	sharepoint
MOSS 2007 Crawl	sharepoint
Cannot Display Image from List	sharepoint
survey results in sharepoint	sharepoint
SharePoint - Web part to view remote list	sharepoint
Programatically create web application & sub site	sharepoint
SharePoint Security	sharepoint
Unit testing code that uses PortalSiteMapProvider	sharepoint
DateTime Hex Format	sharepoint
SharePoint, WCF and Anonymous Access	sharepoint
High CPU usage when deploying content types via a SharePoint feature	sharepoint
"In Sharepoint, what is the actual name of the page layout used for the ""Article page with with body only"" layout option?"	sharepoint
Automatically set list item permission, after new item is created	sharepoint
Customizing SharePoint's NewForm.aspx, or creating my own form... thoughts?	sharepoint
SharePoint: Why does a content deployment job customize all my master pages?	sharepoint
Should I keep solutions and features in a 1-1 ratio?	sharepoint
Change description of a SharePoint group	sharepoint
Must Have SharePoint dev tools	sharepoint
Upload document to specific folder in a SharePoint Document library using WebClient	sharepoint
SharePoint - Posting and Retrieving files Automatically via VBScript	sharepoint
Running away from SharePoint	sharepoint
Filterable SPFIeldUrl in default view.	sharepoint
Controlling drop down lists in Windows SharePoint Services 3.0 Form	sharepoint
Any solution to the Today Calculated Column problem is SharePoint?	sharepoint
Sharepoint: how can i find all the pages that host a particular web part?	sharepoint
Edit .doc in Word via custom Document Library DispForm.aspx	sharepoint
SharePoint List That Pulls From Other Lists	sharepoint
BusinessDataList Web Part Edit view using code.	sharepoint
Customizing default.master in WSS 3.0	sharepoint
Is there any way to change the index of menu items in a SharePoint menu?	sharepoint
OWA Web Part Jumps/Shifts when getting focus on My Site	sharepoint
How should SharePoint developers work with the graphics designer on their projects?	sharepoint
How do you include a JavaScript file from within a SharePoint WebPart?	sharepoint
Writing Database Blobs to SharePoint Document Libaray	sharepoint
How would you display the menu of a Sharepoint 2007 website in a .net web application out of the Sharepoint context?	sharepoint
"How do I define a search scope ""Display Group"" for a Site definition"	sharepoint
Object Model Permission	sharepoint
How to provision a custom page without using the _layouts directory	sharepoint
Import Sharepoint XML based requirements to HP Quality Center	sharepoint
Sharepoint as template application	sharepoint
SharePoint SPContext.List in a custom application page	sharepoint
Passing SharePoint objects as function arguments. Is this bad?	sharepoint
What would make development with SharePoint easier?	sharepoint
Clean document roles in a Doc Library	sharepoint
SPList.GetItems(view) returns an exception when attempting to get item title	sharepoint
"Creating a workflow task generates an ""Invalid field name"" error"	sharepoint
Deploy a resource file to App_GlobalResource folder on activation	sharepoint
SharePoint and Log4Net	sharepoint
Issue with database connection from sharepoint workflow with integrated security options	sharepoint
SharePoint does not find my custom RenderingTemplate	sharepoint
SPListItem.Properties DateTime Fields are in weird Hex format	sharepoint
How do I consolidate entries from multiple employee blogs into a single RSS feed	sharepoint
Sharepoint StateMachine : Handling multiple responses to multiple created tasks	sharepoint
app pool identity - farm admin	sharepoint
How to Run a workflow on an item inserted by an anonymous user	sharepoint
Adding an extra column in the sharepoint list preview viewstyle	sharepoint
Best practices for applying changes to a SharePoint application	sharepoint
SPContext.Current.Web.CurrentUser returns misleading value	sharepoint
"How can I force my SharePoint AjaxSmartPart to use the smaller ""Release"" mode javascript?"	sharepoint
Do I have to use InfoPath forms for every task within a SharePoint workflow?	sharepoint
How does sharepoint recognize a file type?	sharepoint
SharePoint - Adding users from Active Directory in a custom administration form	sharepoint
Disable MOSS auto import of colleagues	sharepoint
"SharePoint/WSS: Modify ""created by"" field?"	sharepoint
Sharepoint List redirect with new id	sharepoint
SharePoint 404 page	sharepoint
Sharepoint web part stops working because of Resources.en-US.resx file	sharepoint
How to find default crawling account for all shared service providers in MOSS	sharepoint
Logging in as another user in sharepoint	sharepoint
Controlling the ID of a custom action item in SharePoint	sharepoint
Problem displaying custom property values for SharePoint custom field types	sharepoint
SharePoint Solution Deployment: How do I prevent SP from resetting IIS when upgrading or retracting a globally deployed solutions?	sharepoint
sharepoint 2007 - custom content type - filtered lookup column	sharepoint
User Experiences for  Visual Studio 2008 extensions for SharePoint v1.3 CTP	sharepoint
Viewstate error on SharePoint custom site page with SPGridView	sharepoint
Easiest way to scrape SharePoint list data to a seperate SQL Server table?	sharepoint
Sharepoint - Information Rights Management error	sharepoint
Sharepoint workflow problem	sharepoint
WebPart in a root site includes a listview which tries to show the content of subsite lists	sharepoint
Best practice for profiling a SharePoint application	sharepoint
Synchronizing Sharepoint and Active Directory Groups?	sharepoint
Reporting on Workflows in SharePoint	sharepoint
Transfer files with versioning using SharePoint and SOAP	sharepoint
Fba roles with SharePoint user groups	sharepoint
http://stackoverflow.com/questions/643853/customaction-not-appearing-in-listview-web-part-for-splist-that-does-not-inherit	sharepoint
Content type custom document information panel	sharepoint
Using Disposable With SharePoint Objects (Web Parts)	sharepoint
How do I use a list from a different site in SharePoint 3.0?	sharepoint
How do I read/write Person metadata from a Word doc stored in SharePoint using VBA or VSTO?	sharepoint
Matlab Error: ??? Cell contents reference from a non-cell array object.	matlab
How to terminate a running process in matlab ?	matlab
Gaussian filter in Matlab	matlab
Matlab: Print text in input field	matlab
How to apply moving windows to a 2D matrix in MATLAB?	matlab
Funny plots in MATLAB	matlab
free matlab environment	matlab
Curves in matlab	matlab
UnsatisfiedLinkError When Loading a Library from Java in MATLAB	matlab
MATLAB: dealing with java.lang.String	matlab
Plotting data with meshgrid	matlab
How to clear the console in Matlab	matlab
Why is Matlab Stateflow 7.7 not throwing errors on undefined variables?	matlab
Launching matlab remotely on windows via ssh?  Impossible?	matlab
How to access a matrix in a matlab struct's field from a mex function?	matlab
Error: Attempted to access data(2,:); index out of bounds because size(data)=[1,7129].	matlab
Matlab Maximum Function Count Exceeded	matlab
How to smoothen a plot in MATLAB?	matlab
How to generate a function of two variables in matlab without using any loop?	matlab
Packages in MatLab for a beginner?	matlab
How can I interrupt Matlab when it gets really really busy?	matlab
Saving matlab sparse matrix to text file	matlab
Java/JAXB error in Matlab when using unmarshal function	matlab
What's the difference between {} and [] in MATLAB?	matlab
"display ""value"" on edit text matlab"	matlab
debug in matlab	matlab
How to write a variable with input ?	matlab
Matlab - Neural network training	matlab
MATLAB: Can axes tick labels be accesed as text objects?	matlab
MATLAB : search and count (?)	matlab
matlab's phi symbol	matlab
Packaging of MATLAB code	matlab
What is the closest thing MATLAB has to namespaces?	matlab
Producing 2D array from a 1D array in MATLAB	matlab
Faster dec2bin funtion for large amount of conversion	matlab
devide two polinomials by using matlab	matlab
image processing toolbox in matlab	matlab
Simulink: implementing a custom transfer function	matlab
How can I find the absolute maximum or minimum of a multi-dimensional matrix in Matlab?	matlab
"Matlab: getting ""Unexpected error status flag encountered. Resetting to proper state"""	matlab
Calculating hamming weight efficiently in matlab	matlab
How can I display an error message in matlab?	matlab
Executing pushbutton callback from another function in Matlab	matlab
How to add a number to a variable?	matlab
joining dots of scatter plot and create line	matlab
What is the equivalent of 'fread' from Matlab in Python?	matlab
How to setup matlab for parallel processing on Amazon EC2?	matlab
Running a Javascript command from Matlab to fetch a PDF file	matlab
How to randomly select from a list of 47 names that are entered from a data file?	matlab
Creating a cylinder with axis centered differently	matlab
Generalized Gaussian Noise generator in matlab	matlab
How to call Matlab functions from linux command line ?	matlab
Converting binary to decimal without using loop	matlab
How can you draw a bezier curve in Matlab	matlab
Passing functions as arguements in Matlab	matlab
Issues with programming General Cross Correlation (GCC) in matlab	matlab
MATLAB: pre-allocation of matrix yields error	matlab
Color part of graph under a line in Matlab	matlab
How to deal with the warnings when importing BNT tools in MATLAB?	matlab
Hooking into MATLAB to evaluate symbolic derivatives from C code	matlab
How can i interchange the row and column of an input data in matlab	matlab
Can the following loop be vectorize?	matlab
Matlab: preallocate a non-numeric vector?	matlab
Quotient in Matlab	matlab
matlab: manipulating two linked matrices	matlab
matlab and linux	matlab
GCD function in matlab	matlab
MATLAB - use a string to set the title of a graph	matlab
Matlab - Find  point of intersection between two vectors	matlab
Problems with Matlab javabuilder and memory	matlab
MATLAB: compute mean of each 1-minute interval of a time-series	matlab
I have a having a a matrix index bounds in matlab	matlab
Using MatLab to calculate signal:noise ratio	matlab
MATLAB Mex interface to a class object with multiple functions	matlab
Matlab: evaluate symbol expression	matlab
What do end-of-line commas do in Matlab?	matlab
How to mark a point in a MATLAB plot?	matlab
Iterating through struct fieldnames in MATLAB.	matlab
How to retrieve the background color of an arbitary image using MATLAB?	matlab
Warning: Ignoring excess mask dialog entries in:	matlab
.NET coupled with MATLAB or R?	matlab
Count struct properties in MATLAB	matlab
"making GIF animation from ""movie"" command"	matlab
MATLAB: convert vector to cell array	matlab
Python to MATLAB: exporting list of strings using scipy.io	matlab
How to preallocate an array of  class in MATLAB?	matlab
GPIB connection to external device using MATLAB	matlab
How to override the default text in MATLAB	matlab
Stumped trying to implement Save/Load object functionality in a MATLAB UI	matlab
Sort a matrix with another matrix	matlab
Match overlapping patterns with capture using a MATLAB regular expression	matlab
In need of a good MATLAB class tutorial	matlab
merging and manupulating files in matlab	matlab
Matlab wont extract first row & column because of matrix dimensions !	matlab
Assigning figure size to a figure with a given handle (MATLAB)	matlab
Piecewise Inline Function in Matlab	matlab
MATLAB - Redefine YTickslabels	matlab
How do I choose computer hardware which best optimizes the performance of MATLAB?	matlab
Matlab deployment: add files to source control?	matlab
shared library locations for matlab mex files:	matlab
Curve Fitting	matlab
MATLAB: comparing 2 columns content	matlab
Matlab: How to get the current mouse position on a click by using callbacks	matlab
To find points of intersection between straight lines & our figure in matlab	matlab
Can we count MATLAB as programming language?	matlab
MATLAB Builder NE (.NET Assembly) Data type question	matlab
matlab error using m power	matlab
How to make Matlab xUnit work on Matlab R2008b (7.7)?	matlab
Compact matlab matrix indexing notation	matlab
MATLAB: Plotting .m file from directory	matlab
MATLAB pdist function	matlab
Turn Matlab plot into image	matlab
MATLAB functions in C++	matlab
sorting a timer in matlab	matlab
Matlab: Filling a matrix with each column being the same	matlab
"Matlab: ""Too many Input Arguments"" when not passing any!"	matlab
How do you handle resources in Matlab in an exception safe manner?	matlab
MATLAB: Drawing a line over a black and white image	matlab
In matlab, how do I apply a function of two arguments to two cellarrays of equal length?	matlab
Matlab - usage of knnclassify	matlab
Tidying up a list	matlab
Symbolic Math in MATLAB, solving simple integration	matlab
how to assign random energy E to every node and compare two nodes for maximum energy and also find distance between them?	matlab
If a Matlab function returns a variable number of values, how can I get all of them as a cellarray, for instance?	matlab
Matlab: identifying uniques in a cell array	matlab
Create a buffer in matlab	matlab
How to convert a web page into an image using MATLAB?	matlab
How to convert m-files to dlls?	matlab
Automatic annotation for matlab plot?	matlab
How do I make a plot in Matlab if I do not know the specific size of the array?	matlab
Call matlab functions in silverlight	matlab
matlab code for the horizontal mean filter	matlab
Using matlab and Time Series object (fints), how can I make an array of them?	matlab
Data streaming in Matlab with input data coming in from a C++ executable	matlab
Run-time error '-2147352567 (80020009)'	matlab
How to automate Matlab/Simulink/Real-TimeWorkshop  code generation?	matlab
Mean filter in MATLAB without loops or signal processing toolbox	matlab
Matlab functions refusing to function depending on placement	matlab
Annotating Charts in Matlab	matlab
Check each pixel for a specific colour (within a certain threshold)	matlab
What is MATLAB? Does it generate executables?	matlab
TreePlot String Labeling MATLAB	matlab
MATLAB: maximum pre-allocated size?	matlab
Function pointers in MATLAB	matlab
Convert cell array of cells into cell array of strings in MATLAB	matlab
Can MatLab understand Java int datatype?	matlab
Matlab book on geometry and image processing	matlab
matlab:find the 4th vertice of a parallelogram	matlab
matlab: binomial distribution	matlab
delete empty cell matlab	matlab
How to get Haskell syntax highlighting on PHP blog	haskell
Good functions and techniques for dealing with haskell tuples?	haskell
Primitive recursion	haskell
Infinite loop in haskell? (newbie)	haskell
Using Haskell's types to replace assert statements or if checks in other languages	haskell
Memoization in Haskell?	haskell
Creating Haskell instance declarations	haskell
"[Haskell] Error ""No instance for (Num [t])"" in Collatz function"	haskell
backtracking in haskell	haskell
Haskell compiler error: not in scope	haskell
Closest equivalent to subprocess.communicate in Haskell	haskell
Haskell: What is the difference between $ (dollar) and $! (dollar exclamation point)	haskell
Many types of String (ByteString)	haskell
How to count the number of times a fuction was called, the FP way	haskell
foldl versus foldr behavior with infinite lists	haskell
Haskell function seems to be limiting integer length - i thought it used bignums?	haskell
Haskell: scary type signature	haskell
how to express {2n+3m+1|n,m∈N} in list comprehension form? ( N is the set of natraul number including 0)	haskell
Level-order in Haskell	haskell
Haskell: Overlapping instances	haskell
Implementing a factorisation method in Haskell	haskell
ghci displaying execution stack	haskell
Any Haskell online contests or problem sets?	haskell
Haskell - how can I check if number is Double/Float?	haskell
install haskell cabal w/o manual dependency resolution	haskell
Is there a way to implement constraints in Haskell's type classes?	haskell
What are the relative merits of wxHaskell and Gtk2HS?	haskell
How do you solve this Haskell problem?	haskell
is it possible to print all reudctions in Haskell - using WinHugs?	haskell
"Haskell: can't use ""map putStrLn"" ?"	haskell
Pros And Cons Of Haskell	haskell
"Why is there ""data"" and ""newtype"" in Haskell?"	haskell
How to get every Nth element of an infinite list in Haskell?	haskell
Haskell type families and dummy arguments	haskell
Program to find the result of primitive recursive functions	haskell
Haskell 64 bit numerical type	haskell
What type of scope does Haskell use?	haskell
How to determine the directory in which a running Haskell script or application lives?	haskell
View Reduction Steps in Haskell	haskell
Int vs Integer in class instance	haskell
Haskell Noob question: What's wrong with my append function?	haskell
GADTs and Scrap your Boilerplate	haskell
Is there any working implementation of reverse mode automatic differentiation for Haskell?	haskell
"Which is your favorite ""hidden gem"" package on Hackage?"	haskell
Haskell Monoid Join Function	haskell
"""Programming In Haskell"" error in sat function"	haskell
Map applied to multiple arguments in Haskell	haskell
Haskell question regarding data	haskell
Write a Haskell interpreter in Haskell	haskell
Haskell. Why Array faster then lists ?	haskell
What does the parantheses signify in (x:xs) when pattern matching?	haskell
Haskell parsing tools - yacc:lex :: happy:?	haskell
Guidelines for applying DRY in Haskell function definitions	haskell
Binding type variables that only occur in assertions	haskell
Haskell: Parsing escape characters in single quotes	haskell
Typed FP: Tuple Arguments and Curriable Arguments	haskell
Pattern matching against a tuple in the IO Monad in Haskell	haskell
Haskell scoping in nested function definitions using where	haskell
haskell: a data structure for storing ascending integers with a very fast lookup	haskell
"How do I write, ""if typeclass a, then a is also an instance of b by this definition."""	haskell
Haskell library like SymPy?	haskell
Stripping newlines in Haskell	haskell
What are some good Haskell Primers/Tutorials for beginners?	haskell
"""Lazy IO"" in Haskell?"	haskell
What is MACID ?	haskell
Euler Problem in Haskell -- Can Someone Spot My Error	haskell
How do I use constants in haskell, to avoid magic numbers ?	haskell
[Haskell] Equivalent expressions produce different results in a function?	haskell
How to use 'someof' in quickCheck (Haskell)	haskell
please help me understand the pattern match in haskell. i'm a little confused.	haskell
Trying to understand Haskell's => vs defining the types	haskell
Operate on values within structurally similar types in Haskell	haskell
State Monad, sequences of random numbers and monadic code	haskell
awkward monad transformer stack	haskell
Writing a time function in Haskell	haskell
Haskell record syntax and type classes	haskell
Explanations about the mechanics of a simple factorial function	haskell
Haskell: Multiples of Numbers in a List	haskell
Getting Cabal to work with GHC 6.12.1	haskell
Is it possible to use unary function instead of binary in `flip`?	haskell
Haskell function composition	haskell
Performance of looping over an Unboxed array in Haskell	haskell
another simple Haskell question	haskell
Why is this form of haskell acceptable, but the other form raises a type error?	haskell
Using MonadPlus in FRP.Reactive.FieldTrip	haskell
putStrLn, type Char does not match [Char]	haskell
how to install haskell openid package in windows	haskell
Why does the following simple Haskell function give slightly strange answers?	haskell
debug output of game objects in Haskell/Yampa and HOOD	haskell
Howto use mongoDB bindings for haskell.	haskell
Haskell - specyfing kind in data declaration	haskell
What's the status of multicore programming in Haskell?	haskell
Haskell image processing library?	haskell
What is primitive recursion?	haskell
How do I use Haskell's FFI on structs?	haskell
How do laziness and I/O work together in Haskell?	haskell
Haskell CPS Programming Style Problem	haskell
How do you route stdin from a file to a function when running GHCI	haskell
If you can't change a variable's value in Haskell, how do you create data structures?	haskell
Modifying the pretty printer from haskell-src-exts	haskell
Have J style adverbs, forks etc been emulated via libraries in mainstream functional languages?	haskell
How much math do I need to become productive in Haskell?	haskell
How to do conditional compilation in Haskell?	haskell
Haskell tool to rewrite import statements to name all imports?	haskell
simple putStrLn in Haskell/Yampa with arrows syntax	haskell
Ambiguous type variable	haskell
Equivalence testing in Haskell	haskell
"Haskell newbie question: What is ""lifting""?"	haskell
"Mysterious word (""LPS"") appears in a list of Haskell output"	haskell
Haskell type classes and type families (cont'd)	haskell
How to zip multiple lists in Haskell?	haskell
[Haskell] Space Leak	haskell
First-order logic formula	haskell
Raise ParseError in Haskell/Parsec	haskell
Dealing with large files in Haskell	haskell
Haskell: Constrain function on type Double to only work with Integers	haskell
haskell grouping problem	haskell
Pattern match data types and their nested name in Haskell	haskell
How does this constitute a Haskell rigid type error?	haskell
Are there tools that would be suitable for maintaining a changelog for a Cabal Haskell package?	haskell
implementing a per-digit counter using the list monad	haskell
pointers in haskell???	haskell
Functional proofs (Haskell)	haskell
Haskell type error using infered type	haskell
Outputing UTF-8 string on Mac OS's Terminal	haskell
Confusion about currying and point free style in Haskell	haskell
Which Haskell package contains given module.	haskell
Why is ghc evaluating my infinite list?	haskell
Are random numbers in Haskell strict?  Why does this program get a stack overflow?	haskell
Implementing a very simple 'Wine Rating System' in Haskell	haskell
"Issue with Haskell's ""do"""	haskell
How do I get ghci to see packages I installed from cabal?	haskell
Pattern matching data types in Haskell.  Short cuts?	haskell
Finding the leaves of an inductively-defined tree	haskell
Haskell and random numbers	haskell
What are zygo/meta/histo/para/futu/dyna/whatever-morphisms?	haskell
What can be improved on my first haskell program?	haskell
Is it better to use the State Monad, or to pass state recursively?	haskell
type depence in Haskell	haskell
Is there a way to optimise this program in Haskell?	haskell
Why does ghci say that 1.1 + 1.1 + 1.1 > 3.3 is True?	haskell
"Is do-notation specific to ""base:GHC.Base.Monad""?"	haskell
Nice small simple real life programming example in Haskell?	haskell
Call an haskell function in .net	haskell
STUArray with polymorphic type	haskell
Automatic conversion of types for FFI calls in Haskell	haskell
Haskell: Composing two error-raising functions	haskell
Show a list of words repetited in haskell	haskell
Using perfectly formatted input as list in Haskell	haskell
Where next, after Haskell?	haskell
Wordpress Update through email	wordpress
PHP: Iterate through folders and display HTML contends	wordpress
Wordpress, WP_Query with custom taxonomy and custom post type	wordpress
add column to wordpress database	wordpress
Wordpress show preview of Article/Site	wordpress
Getting the Wordpress Rss file	wordpress
How to categorize Google Docs published as posts to Wordpress	wordpress
Adding custom tags in Wordpress	wordpress
Sharing WordPress session cookie with MediaWiki	wordpress
"How to pull ""most recent post"" data from a Wordpress blog?"	wordpress
How do I remove CSS from WordPress admin sections	wordpress
Need help changing Permalinks in Wordpress, I've tried everything..	wordpress
Wordpress Content Box not formatting correctly.	wordpress
Wordpress posts not styling	wordpress
"Assume that WordPress is an almost-there CMS. What Plugins would you add to the 'core' to make it equal to ""Real"" CMSes?"	wordpress
Custom URL rewrite in wordpress	wordpress
Wordpress Admin Section users.php	wordpress
Wordpress Category Template Question	wordpress
Naming Tags (Wordpress)	wordpress
How do you remove inline styles in Wordpress?	wordpress
How can I make unlimited page widgets for wordpress?	wordpress
Wordpress Post order	wordpress
php date() function displaying wrong time	wordpress
Wordpress integration with asp.net	wordpress
wordpress url resolution of subpages from within plugin	wordpress
wordpress user uploads, any solution?	wordpress
How do you sanitize an input in wordpress	wordpress
In WordPress, restrict number of posts a user can post in a day	wordpress
wordpress add comment like stackoverflow	wordpress
Migration of Wordpress sites to a local WAMPserver, now the pages cannot be found	wordpress
Wordpress - using 'get_post' to select only those posts that are in two specified cats at once.	wordpress
how wordpress can un-slug a title	wordpress
Creating a Archive in Wordpress Datewise for a Particular Category	wordpress
Different number of posts (WordPress)	wordpress
How to correctly modify this Wordpress Function for widgets?	wordpress
Wordpress Post # of #	wordpress
in wordpress, how do I know what page is current?	wordpress
Wordpress Admin Plugin	wordpress
How to add ads to the end of RSS on wordpress?	wordpress
Wordpress filter to modify final html output	wordpress
NAVT WordPress Plugin - Not working on index.php	wordpress
What is the best method for creating your own Wordpress loops?	wordpress
WordPress: Useful plugins for building a user manual?	wordpress
Wordpress based website blocked by commercial proxy policies	wordpress
Wordpress Category ID vs Eval Issue	wordpress
WordPress front page (homepage) fails to redirect when static front page is set.	wordpress
How Can Wordpress Easily Provide A Voting and Commenting View For 5 Page Layout Possibilities?	wordpress
wordpress my_deregister plugin from page	wordpress
wordpress functions.php	wordpress
Why does WordPress prefix its column names with the table name?	wordpress
Wordpress uses MySQL fulltext search?	wordpress
Is wordpress a good platform for webapp development?	wordpress
Problem with CSS on Wordpress	wordpress
Setting custom homepage for Wordpress blog	wordpress
Which wordpress forum plugin is best to use for a corporate site?	wordpress
Wordpress SEO Features	wordpress
Designing WordPress Themes using Dreamweaver	wordpress
Using CMS to make webapps.	wordpress
Wordpress Plugin or quick php function for conditional image size	wordpress
Can I install/update wordpress plugins without providing ftp access?	wordpress
WP-Contact Form 7 -- PHP Question	wordpress
Getting the tags for a post in a Wordpress plugin	wordpress
Plugin to avoid share username in Wordpress	wordpress
What does apply_filters(...) actually do in WordPress?	wordpress
Wordpress custom query pagination	wordpress
Wordpress OR Joomla?	wordpress
What do you prefer ? Writing a Wordpress plugin or child theme ?	wordpress
Wordpress Widget auto activate	wordpress
Issues with 404 pages when inserting posts and changing permalink to /%postname%/	wordpress
Wordpress PHP Image change depending on a language	wordpress
What is the best way of retrieving a specific post in Wordpress?	wordpress
Random WordPress Admin 404s	wordpress
how covert post into othe language in wordpress?	wordpress
Post pages in Wordpress 2.9	wordpress
"d13slideshow for WordPress and ""URL file-access is disabled"""	wordpress
Adding a custom variable to get_posts	wordpress
Wordpress Add Links	wordpress
Internal linking in Wordpress...	wordpress
What is Wordpress doing for content encoding in it's mysql database?	wordpress
Why Can't I Include A Blog?	wordpress
HTTP error when uploading an image using default Flash Uploader in Wordpress	wordpress
External form with javascript validation causing wordpress 404 error	wordpress
alternative to update_option() in wp-admin	wordpress
using static wordpress login form on front page but links to another wp install?	wordpress
Way to check whether TinyMCE is active in WordPress	wordpress
WordPress Post Date Changes On Update	wordpress
Noob Question: Wordpress Looping	wordpress
how to list wordpress categories by alphabet ?	wordpress
Where are wordpress default widget files or functions located?	wordpress
Wordpress Not Publishing Posts To Custom Template	wordpress
Wordpress - Skip category page if only one post in category	wordpress
Trying to make/set up an events calendar in Wordpress & it's not quite what I need	wordpress
Showing 10 recent (same month/year?) items from a category (Wordpress)	wordpress
how to grab my wordpress posts from different subdomain?	wordpress
Is there an easier way to add menu items to a wordpress navigation menu?	wordpress
Add a Blog to an Existing Webpage.	wordpress
Wordpress Lightbox Gallery by post	wordpress
URL rewriting in Wordpress	wordpress
What to keep in mind when making Wordpress themes	wordpress
Where to place a query to show only one post in Wordpress	wordpress
This is asking a lot, I know, but: Help me translate this Glossary plugin for WP	wordpress
Looping Through Set Number of Posts in Wordpress, Then running same loop again on next set, etc.	wordpress
Getting WP Functions to Return rather than Printing Immediately	wordpress
Migrating Wordpress to another host: Can't login b/c it's confused about the host!	wordpress
Wordpress - multiple WP Query objects into one?	wordpress
Need a little bit of help with text alignment in wordpress	wordpress
How do I check for a tag's existence in a post in Wordpress?	wordpress
Is there a wordpress plugin for creating an API from your site?	wordpress
"Are There Any ""Blank"" Wordpress Designs?"	wordpress
Stripping images from post teasers/excerpts in Wordpress	wordpress
How to check whether your work on WP or WPMU ?	wordpress
Wordpress redirect on password to certain page	wordpress
jQuery lightbox plugin change apperance of my wordpress site	wordpress
Download page template for Wordpress	wordpress
Wordpress SQL Select Multiple Meta Values / Meta Keys / Custom Fields	wordpress
Wordpress homepage problem	wordpress
wordpress contact or message pages	wordpress
WordPress sub domain htacess problem	wordpress
How to add Remember me function at custom login box ?	wordpress
Wordpress Mobile Version	wordpress
How can I remove jquery from the frontside of my WordPress?	wordpress
include link list depending on category	wordpress
How to get the category title in a post in Wordpress?	wordpress
"How to make a ""recent seen pages"" for user registered in wordpress"	wordpress
Capturing a Map to embed in a Wordpress Blog post	wordpress
access and display wordpress posts from out of wordpress.	wordpress
Where to find Wordpress API documentation?	wordpress
Possible Wordpress URL rewriting issue	wordpress
How to order categories in wordpress?	wordpress
Need to increase PHP memory_limit for specific directory NOT entire server	wordpress
How do I place the blog portion of wordpress in a subdirectory, while keeping Pages at the root?	wordpress
Sorting Featured Posts (Wordpress)	wordpress
How do I create image roll over nav buttons in Wordpress	wordpress
Can a WordPress blog pull content from Django pages?	wordpress
Wordpress Site Monitoring software / service	wordpress
WordPress: Is it possible to make one particular post always on TOP on blog.wordpress.com?	wordpress
Wordpress host IP changed.	wordpress
How to output a menu showing 3+ levels of a page hierarchy branch ?	wordpress
Custom Formatting before Save Wordpress	wordpress
Get page content with theme structure in Wordpress	wordpress
ampersand problem with wordpress categories	wordpress
blog post content via url parameters (meta) in wordpress	wordpress
How to install wordpress on MS SQL	wordpress
What columns stores the slug in wordpress	wordpress
Wordpress error?	wordpress
Wordpress - Get name of Category a post belongs to?	wordpress
Center block element in element	wordpress
Wordpress : display all articles of a month on one page	wordpress
Get three posts before a certain date in Wordpress	wordpress
Redirecting a /?p=xxx wordpress URL	wordpress
TransactionProxyFactoryBean when switching from configuration-based Service beans to annotation based service beans	spring
Logging user agent info on login with Spring Security	spring
template method pattern	spring
Putting values in error.getModel in onBindAndValidate	spring
spring classloader isolation problem on jboss	spring
Mock object and Spring annotations	spring
Spring Transactions in diffrent DAOs does not work anyway?	spring
Spring-MVC is adding on an extra .jsp extention to the URL a user enters	spring
Startup performance of Spring @Configurable with Compile Time Weaving	spring
global properties in spring	spring
What are the available options to retrieve Spring-managed beans in a Log4J Appender inside a Spring-managed web application?	spring
Is It Possible To Spring Autowire the same Instance of a protoype scoped class in two places	spring
Beans... what is it actually	spring
Applying additional aspectj around advice to a spring transactional method.	spring
Spring best practice for locking domain objects?	spring
AbstractTransactionalJUnit4SpringContextTests: can't get the dao to find inserted data	spring
Spring 3 DI using generic DAO interface	spring
Creating temporyary JMS jms topic in Spring	spring
Spring + Tiles2 + Freemarker - integrate via Freemarker Servlet or via Spring's FreeMarkerViewResolver?	spring
Spring to understand properties in YAML	spring
Problem with spring quartz	spring
No Hibernate Session bound to thread	spring
Can I have multiple security contexts with spring security?	spring
creating spring bean	spring
spring ioc injecting conrete implementation of interface to test	spring
Quartz JobStore with Spring Framework	spring
spring transactional cpool. Which one do I use?	spring
Spring @Autowired usage	spring
spring binding formmultiselect	spring
Is there a static way to get the HttpServletRequest of the current request	spring
Java spring database application won't quit reference to org.enhydra.jdbc.pool.PoolKeeper is still active why?	spring
Test if Spring Scope is active	spring
Spring Batch validation	spring
lazyinializationexception with transactional annotation in messageconvert	spring
App Servers vs. Spring	spring
Different i18n in spring according to url	spring
Spring-modules caching not working... silently.	spring
Integrating JCaptcha with Spring Security	spring
How can I make properties files mandatory in Spring?	spring
"Junit4 + Spring 2.5 : Asserts throw ""NoClassDefFoundError"""	spring
Validation framework for business app built on Spring 2.5	spring
why does Spring use XML for component wiring?	spring
Where to open sessions in a Spring/Hibernate stack?	spring
Where is the sample applications in the lastest Spring release(Spring Framework 3.0.2)?	spring
Spring @notation documentation	spring
How do I get the value of the jdbc.batch_size property at runtime for a Web application using Spring MVC and Hibernate?	spring
Mapping both static and dynamic files in Tomcat/Spring?	spring
Spring Transaction Management Test	spring
extending spring form tag library attributes	spring
Can I dynamically load additional Spring configuration files into an existing WebApplicationContext?	spring
Spring Web Flow  Error MEssages	spring
Spring Security basics	spring
Spring dependency injection in construcor with annotations	spring
spring roo backup command lost my files	spring
spring - use both simple SimpleUrlHandlerMapping and AnnotationMapping	spring
spring ibatis mysql transactions	spring
Spring and JSF and JPA	spring
How to use multiple ViewResolvers in Spring?	spring
Registering a shutdown hook in Spring 2.5	spring
Best Spring/Hibernate configuration for never changing tables	spring
spring jdbc RowCallbackHandler nightmare	spring
array dependency injection in spring?	spring
How to create CommonsMultipartFile object given only a file.	spring
Problem creating bean of sessionFactory in spring-hibernate configuration	spring
Database connection management in Spring	spring
Trouble stopping Tomcat due to apparent threading issue..	spring
Roles/Priviledges in a Spring/Hibernate application	spring
How to create hyperlink in Spring + JSP	spring
identity from sql insert via jdbctemplate	spring
Could someone explain Spring Security BasePermission.Create?	spring
How can I get access to spring container?	spring
Estimating a Spring/Hibernate project.	spring
Spring & Hibernate SessionFactory - recovery from a down server	spring
Start the H2 database in server mode via Spring	spring
Spring struts and forms	spring
Is there any advantage to use spring DataAccessExceptions instead of JPA PersistenceExceptions ?	spring
No Runnable methods Error From Base Test class	spring
How do I create a Spring 3 + Tiles 2 webapp using REST-ful URLs?	spring
Can a Spring form command be a Map?	spring
Configuring Spring based servlet with sysadmin defined properties	spring
Is fine grained control of aspectj-autoproxy possible in spring ?	spring
CGLIB proxy error after spring bean definition loading into XmlWebApplicationContext at runtime	spring
Spring-AOP	spring
spring - @ContextConfiguration fail to load config file in src/test/resources	spring
Removing Spring.Cache	spring
IDE support for Spring framework; Are they worth using?	spring
Using WebServiceTemplate with a keystore	spring
What would be the Spring way of using TCP connections?	spring
Spring redirect: prefix issue	spring
How to log the time taken by methods in Springframework?	spring
"how to map ""a-b"" query to a command object in Spring MVC"	spring
Spring - Annotation Based Controller - RequestMapping based on query string	spring
How to relate between two classes with mongodb and spring?	spring
@Transactional not working with spring and hibernate	spring
Spring - config apache commons email	spring
IllegalArgumentException for dataSource in Spring application	spring
How to define Spring datasource in controller ?	spring
Spring Framework Events	spring
Unable to locate Spring NamespaceHandler for XML schema namespace	spring
I've a function updating database table using Spring's JdbcTemplate and for some reason there was exception that connection is read only u can not update any database related changes. How to resolve these problem?	spring
Unit Testing Hibernate's Optimistic Locking (within Spring)	spring
Spring Batch: java.io.IOException: Stream closed exception when combining MultiResourceItemWriter and FlatFileItemWriter	spring
Spring - Rewrite one URL to another	spring
Spring deployment-level configuration	spring
Problem with Autowiring & No unique bean	spring
Which maven modules to include for spring 3.0?	spring
Spring and the anemic domain model	spring
What are the differences between Spring integration and JBoss jBPM?	spring
client side spring	spring
Spring: Same object, different validation	spring
In a spring messages.properties, how to ensure line break of error message when using an error code as key ?	spring
How to configure spring HandlerExceptionResolver to handle NullPointerException thrown in jsp ?	spring
Have you found success with a Spring  and Hibernate Web Application	spring
Access and modify attributes/objects which are not part of the form backing bean	spring
Spring servlet-mapping	spring
Workflow engines that integrate easily/work well with Spring Web?	spring
Is it possible to partially autowire a spring bean?	spring
Rewrite spring-security redirect URLs	spring
Access properties file programatically with Spring?	spring
How to tie the Lifecycle for a Spring Bean to the webapps' lifecycle ?	spring
Sharing Spring Security Configuration Between Applications	spring
How do i convert JSP facelets to Code in a servlet ?	spring
Where is the debug class path in netbeans / where does the spring config XML file go?	spring
How do I setQueryTimeout on SimpleJdbcTemplate?	spring
Spring MVC defaultValue for Double	spring
During Spring unit test, data written to db but test not seeing the data	spring
Spring JPA and persistence.xml	spring
spring custom namespaces with maven	spring
Can anyone point me to Spring MVC, Tiles, Freemarker integration example?	spring
How to bind IP address to a Spring 3 @ModelAttribute?	spring
Getting template text from FreeMarker in Spring app	spring
Null Inner Bean with Spring IoC	spring
Best way to set HTML head title in a Spring+Tiles2 application?	spring
Spring 3.0 set and get session attribute	spring
Different views with Spring's SimpleFormController	spring
Is the following utility class thread-safe?	spring
Pentaho Acegi Security Framework Digest Authentication & Ruby on Rails	spring
Spring MVC configuration question	spring
sitemesh and spring MVC decorator pattern problems	spring
em.persist seems doesn't persist data on postgreSQL db	spring
Spring - Have multiple submit buttons in a form and determine which was pressed in a controller	spring
Trouble configuring AspectJ LTW with Tomcat and Spring	spring
how to disable spring bean loading log	spring
Best way to pass objects between controller actions in grails	spring
TestNG and Spring 3	spring
Custom 404 using Spring DispatcherServlet	spring
An RMIPRoxyFactoryBean factory in Spring?	spring
in Spring.config, can I define object of type string?	spring
When does Spring create instances of objects that are injected	spring
Are there any examples/tutorials of using Spring 3.0 with Cassandra as a backend?	spring
Magento Add to cart not working	magento
Magento - Email Shipment = Default	magento
How to display configurable product in each color in product listing?	magento
Magento: Display sub-category list	magento
Magento Store - Don't Send Newsletter Success Email	magento
Show Category Image with Link in Magento	magento
Want to add custom option from the frontend of magento	magento
Magento Checkout success page product price and SKU retrival	magento
add more admin and allow permission in magento site	magento
magento stock management with external inventory management program	magento
Magento: The best way to hook into the checkout process	magento
Magento Web Service Errors	magento
Magento : manually imported product partially saved	magento
How do I create a Magento module or widget that will appear on the shopping cart page?	magento
Magento - How to translate the module mini-form search	magento
Apply discount directly to subtotal in magetno..	magento
How to cache a collection in Magento?	magento
Magento category display problem on homepage on the left and right column	magento
Magento, translate validation error messages	magento
MagentoCommerce development environment domain issue	magento
"Magento - use an alternate ""price.phtml"" (in addition to the existing one)"	magento
"Adding Thumbnail Image on ""Related Products"" on the Backend of Magento"	magento
magento 1.4, why does a configurable product have a sku	magento
Magento Developers: Is Magento really -that- good?	magento
"Getting error in manage categories - not found for attribute ""navigation_column"""	magento
advanced search with configurable product in Magento	magento
Magento Product Details Image Size	magento
Building magento modules	magento
Magento product listing using ajax	magento
Magento help with creating model in custom class	magento
Filtering by category in Magento 1.4	magento
Magento API Uploaded products not appearing in frontend - Unless they are re-saved in backend.	magento
Magento: case/tiered pricing and being able to break out of case and price for individual skus	magento
Magento - Pricing Matrix?	magento
Magento: placing block on custom template	magento
What files in Magneto have no purpose being in source control?	magento
Magento Custom Module, Fatal error: Call to a member function setFormAction()	magento
Magento: get order id to use in outside application	magento
How to solve 404 not found problem in Magento	magento
Magento: Column not found: 1054 Unknown column 'e.display_price_group_0' after rebuilding flat catalog product	magento
How to hide an active category in Magento without disabling the URL?	magento
Magento - Adminhtml - Get id of order just created	magento
How is Magento when it comes to adding custom functionality?	magento
adding image through inline css in magento	magento
Magento & Google Checkout & Tracking	magento
Magento: Extending Customer Account Controller to add actions to the forgot password steps	magento
sort categories according to date when its added	magento
Magento guest checkout option not showing up regardless of allow guest checkout setting	magento
magento changing Shipping Method	magento
Magento ACL configuration	magento
Magento product's category	magento
Search by category name	magento
add custom field to onepage checkout in magento	magento
Magento - How to replace 'Home' in the breadcrumb?	magento
"""Sorry, no quotes are available for this order at this time"" in Magento"	magento
How can I add rating information to a review	magento
get magento module config data in Observer	magento
Magento - Not able to display tier pricing in product view	magento
Magento - change subject in newsletter subscription success email?	magento
Magento - 2 or more observer on same event	magento
Magento createBlock method not working, displaying static block data	magento
Magento API: Assigning preexisting simple products to configurable products	magento
Connect to the Magento API using C#	magento
How can I sell a profile on magento?	magento
What is the conceptual difference between a Product and a Quote Item	magento
Magento user created attribute for products is not saved...	magento
magento XML RPC problem Class 'Zend_Http_Client' not found in...	magento
Magento : Getting Attribute Code	magento
How to restore a quote in Magento when returning to the Onepage checkout?	magento
"Magento ""Products Ordered"" report?"	magento
Magento-How can i override admin module correctly	magento
Ways to call Blocks within Magento: createBlock vs Layout xml file	magento
[MAGENTO] How to use an external lib? (PclZip)	magento
How to change listing language in Magento	magento
Multiple magento stores on single domain.	magento
products not showing up in magento frontend	magento
Magento: find products without images (no image)	magento
New module in magento not updating layout	magento
colorbox integration in magento	magento
Magento Problem	magento
Magento: Getting Product Url's for Products within a Grouped Product	magento
issues with magento	magento
Remove Tax at Checkout for B2B customers in Magento	magento
magento product export custom options	magento
Cannot get new product attribute in grid display	magento
Confirm bug Magento 1.4 'show/hide editor' in CMS	magento
"magento extension ""remeber me"" not working"	magento
Access to filter var attribute?	magento
help with Magento: Controller file was loaded but class does not exist	magento
Obfuscating a Magento module	magento
Magento - Send emails for different order status	magento
Magento - Cronjob outside magento to update shipment status	magento
Flex, Cairngorm and XML-RPC	magento
Creating an admin url for Magento that is admin.magentostore.com (not /admin)	magento
which file? to edit the breadcrumbs starting point	magento
magento price getPrice() value	magento
Overwriting / Overloading a controller class in Magento	magento
Magento validation problem	magento
Magento - Use Short description for Google base description	magento
Update Magento cron job setting in config.xml of a given module	magento
Magento: which catalog_product_flat I need to select from? and what is catalog_product_entity_datetime table?	magento
"Magento - Hide price and ""Add to Wishlist"" link in Category product list page"	magento
Modify automatically an attribute with magento	magento
how to configure Magento in my local xampp	magento
Magento > product displaying in subcategory but not in the category	magento
Uploading Imaghes via the Magento SOAP api	magento
Magento clearing log data	magento
Saving In Magento Taking A Very Very Long Time	magento
How can I overide a local module in Magento?	magento
Magento 1.4 - Display All Products	magento
free shipping based on product weight in magento	magento
Free downloadable products in Magento	magento
Magento Trying to set the session id to programmitcally add to cart	magento
Magento vs. CodeIgniter and writing from scratch	magento
Importing/parsing XML from URL into Magento	magento
Magento - Layout	magento
Magento Rule Model override	magento
How to create PDF for product description in Magento	magento
How do I get only the selected products from an order object?	magento
Creating a configurable Magento attribute from scratch	magento
user group gets page access	magento
"Magento - Using alternative ""reviews count"" on category list page"	magento
Magento: Display # of pages in category list page	magento
Magento throwing exception on save for missing store_id	magento
How do I change the admin header color in Magento?	magento
Magento Customer Account/Dashboard page	magento
Can't log in to Magento Admin	magento
Create a new Block in Magento	magento
Magento Backorder Availability Message	magento
How to Perform a Bulk Product/Category/Sub Category Import With Magento?	magento
Magento -> How can I list products with same multiple select attribute?	magento
Checkbox filtering in Magento admin grid	magento
Custom email forms in Magento	magento
Magento module - overridden a controller, adding templates	magento
Magento seasonal products	magento
magento - error on checkout page	magento
Troubles after installing Two stores with same php docroot	magento
Megento Module action on ProductView	magento
How to get data for an entity (for example customer) from eav_attribute table to be shown in Customer Grid for admin	magento
mangento in postgres or oracle database ?	magento
"""Magento Tax Zones & Rates"": how to incorporate store location and price dependencies for Tax Rates"	magento
Magento connect manager problem	magento
How can I get a list of products related to an invoice in magento?	magento
Magento google products site html help	magento
How can Set Current currency in paypal in magento?	magento
Magento topSearch doesn't work in template	magento
Estimate Shipping and Tax problem in magento	magento
Magento eCommerce Templates	magento
magento onepage checkout problem	magento
How can you change category position per store view	magento
Is it possible to set-up a personal SVN Remote Repository which can be accessed through the Internet?	svn
Running subversion under apache	svn
Nuking huge file in svn repository	svn
SVN performance after many revisions	svn
Visual SVNServer with Trac	svn
"Is there some way to commit a file ""partially"" in TortoiseSVN?"	svn
Rearranging project after SVN checkout	svn
"SVN: Is there a way to mark a file as ""do not commit"""	svn
Can you force an apache restart in a post-commit svn hook?	svn
svn access to a https repository: username / password always being prompted for	svn
How to tell SVN to ignore files for all team members	svn
SVN -Change directory structure on an existing repository	svn
Subversion not merging changes into renamed files?	svn
Help with SVN Setup	svn
subversion prevent listing of a repository in folder with SVNParentPath	svn
How do you retrieve the commit message and file list for a particular revision?	svn
SVN - Retrieving Useful Information	svn
An online SVN client	svn
How do I do an exclusive checkout in SVN?	svn
How to dlete files from SVN that have already been deleted from the FS?	svn
Unable to commit to Subversion	svn
Running a command with every svn commit	svn
How to require commit messages in VisualSVN server?	svn
Is there a way to change a SVN users username through the entire repository history?	svn
What do you deploy to clients SVN branches or tags	svn
LocationMatch and DAV svn	svn
How to prevent svn from expanding $Id$ keyword?	svn
Robust SVN export and copy script?	svn
What is the limit of source repositories in Visual Source Safe 2005	svn
What is the best way to make files live using subversion on a production server?	svn
Subversion in a single picture	svn
error when switching to different svn branch	svn
svn post-commit hook doesn't have persmissions to create file in working copy directory	svn
How do I list all repositories with the SVNParentPath directive on Apache+SVN?	svn
SVN - Delete existing repository	svn
How do I find the number of times a file was revised in subversion?	svn
what is your favorite web app deployment workflow with SVN?	svn
Resolving SVN merge postponed conflicts recursively	svn
Can the same files be committed to 2 SVN repositories?	svn
SVN Weirdness: Is It Possible It's Not My Fault	svn
Safe to share a Subversion working copy between OS?	svn
How to find out Subversion repository version?	svn
Using SubVersion as a standard source control repository for a large development firm	svn
Can't delete recycling bin when code from svn is in it	svn
Using Subversion trunk as DocumenRoot	svn
How do you manage your run once sql install scripts in subversion?	svn
Access denied when blaming with ToroiseSVN	svn
How to do a bulk svn mv in Unix	svn
How to use Subversion for non-compiled language?	svn
Easiest/best way to set up SVN commit emails?	svn
Fast recursive grepping of svn working copy	svn
Change default SVN diffing tool	svn
Perforce blame	svn
how to update a file in svn?	svn
Anyone have commit notification hook script that will send email upon commit of codes?	svn
How do I sync between VSS and SVN	svn
Java Class file from SVN to Tomcat on server: How to compile automatically?	svn
How to switch back to a previous version of a file without deleting its subsequent revisions?	svn
"Eclipse ""Share Project"" by hand?"	svn
How to use an Internet Subversion respository when devloping code?	svn
What causes svn commit to fail and report a file/dir as obstructed?	svn
How do I copy my entire working copy between hard drives?	svn
When does svn BASE become equal to the HEAD	svn
How do you get a list of changes from a Subversion repository by date range?	svn
Visual Studio 2008 Source Control Explorer with Subversion	svn
tortise svn icons not showing up under windows 7	svn
SVN in-place import and checkout	svn
Which naming conventions do you use for SVN Branches and Tags?	svn
SVN Update problem in Eclipse	svn
Distributing SVN ( Master & Mirrors )	svn
shared components throughout all projects, is there a better alternative than svn:externals?	svn
How do i make my colleagues not despising SVN?	svn
View Content of Deleted File Svn	svn
How to merge from branch to branch and back again (bidirectional merging) in SVN?	svn
Subclipse svn:ignore	svn
How to get daily commit count and the number of modified paths from svn repository?	svn
SVN Repository Search	svn
How can i check out just the trunks of multiple projects from the same repository.	svn
Is there a metadata exclusion filter for the SVN DIFF command?	svn
How to change where Subversion repositories are stored?	svn
svnserve with LDAP	svn
"What is a working copy and what does ""switching"" do for me in Tortoise SVN?"	svn
SVN marks entire files as conflicted	svn
tortoise svn in system tray possible?	svn
files end up in wrong directory after svn copy	svn
Which Eclipse Subversion plugin should I use?	svn
SVN: set properties on directories only	svn
One SVN repository or many?	svn
What is the correct way to restore a a deleted file from SVN?	svn
How do I restrict Apache/SVN access to specific users (ldap/file-based authentication)?	svn
How can I speed up SVN updates?	svn
Can subversion be hosted on amazon's hosted cloud?	svn
svn externals not working	svn
How can I branch in SVN and have it branch my svn:external folders as well?	svn
Is it safe to commit more files as a pre-commit hook	svn
Is there a tool that can display a SVN repository visually ( i.e. pretty charts )?	svn
What is the more efficient version control methodology - checkout or merge (ie Perforce vs Subversion)	svn
Can I keep CruiseControl.Net's ccnet.config in svn, then have CruiseControl update its own config file when a change is checked in?	svn
publishing a website  using svn export	svn
How well does SVN work for Office 2007 documents?	svn
Svn ignore versioned on update	svn
Automatically find the revisions to merge in Subclipse	svn
Vsssc and Vssscc files - usefull for SVN?	svn
Querying for svn revision suddenly seems slow (since svn 1.5 maybe?)	svn
Which is the command to query a Subversion repository for all files checked out to a specific user?	svn
Access Denied to all SVN Directories	svn
Create a tag upon every build of the application?	svn
Very slow merge with Subversion 1.5	svn
How to use Svn and Perforce simultaneously	svn
How can I determine who locked a file using SVN	svn
Timing the Release branch	svn
version control on large files	svn
Migrating to Team System from SVN & Cruise Control.NET and back	svn
"How can svn co give a ""directory already exists error""?"	svn
How to use svn with emacs (psvn can't create tunnel)	svn
How to get started with svn:externals?	svn
Confusing Subversion Status !M	svn
Code freeze in SVN	svn
New folders are not uploaded in SVN	svn
Best reflection of extract-interface refactoring in subversion	svn
svn update not working in post commit	svn
How do I connect to a remote svn server?	svn
Have you integrated Mantis and Subversion?	svn
svn ignore without deleting files?	svn
Need help adding files to a subversion repository.	svn
Local copy of SVN repository	svn
Single read-only user for svn	svn
How do you stop SVN Checkout from bringing back files that were deleted from the project?	svn
Import to the same Subversion repository directory multiple times?	svn
Do you use the branches/tags/trunk convention?	svn
Difference between checkout and export in SVN	svn
Branch off a specific directory from one SVN repository into own repo	svn
Is this the correct step-by-step and organization for creating an SVN repo with multiple projects and vendors?	svn
Order of svn diff revision range	svn
obtain current svn revision in webapp	svn
VisualSVN wants a username and password	svn
How to test that test if a path is (or isn't) writable without writing nothing in it.	svn
Can you modify text files when committing to subversion?	svn
svn merge with revision not doing what I expect	svn
How to add CVS directories recursively	svn
How to reach past revisions trough an HTTP client	svn
Adding a SVN repository in Eclipse	svn
Subversion: Allow both svn based (passwd file) and windows domain authentication	svn
After adding a symbolic link in a svn repository I keep receiving an error inside of that directory	svn
SVN merge doubt	svn
What's the least painful way to transfer local Subversion changes to another machine?	svn
How do you make eclipse use an existing svn working copy?	svn
svn+ssh with putty session, not working in cygwin	svn
SVN Problem	svn
How can I create a directory listing of a subversion repository.	svn
Progress Bar in perl	ajax
AJAX wont POST to URL	ajax
Ajax doesn't work in iPhone safari	ajax
AJAX popup causes screen to re-load using ASP.Net	ajax
Star rating in AJAX with Ruby On Rails	ajax
.ajax will not POST, but will GET with on problem	ajax
IE 7 redirecting after jQuery ajax calls	ajax
How to make SO tags autocomplete with Ajax	ajax
How do I make Ajax calls at intervals without overlap?	ajax
My app is maxing out CPU usage in Firefox	ajax
AJAX checker script, problem with redirect	ajax
Does Rails' Ajax support make JSON or XML an easier format to work with?	ajax
Ajax - How refresh <DIV> after submit	ajax
dynimically created DOM can't hold up in cache	ajax
Refresh Using Ajax/PHP	ajax
Ajax: Load XML from different domain?	ajax
MaskedEdit Extender lost data on postback	ajax
"AJAX: How do I make the button submit after I press ""Enter""?"	ajax
AJAX - Do I need to return a full HTML document on the server side?	ajax
What stylesheet gets used by loading ajax content?	ajax
ajax calls being called too fast.	ajax
Progress Bar using javascript	ajax
Best Technologies for AJAX Web Development	ajax
can I update a label using ajax, instead of a textbox?	ajax
Best way to show notifications and messages LIVE on a webpage?	ajax
why this ajax request is so fast but mine is not ?!	ajax
Ajax with slide effects onready witout using a toolkit	ajax
Compatibility of Comet with current technology	ajax
Customizing an AJAX AutoCompleteExtender with a checkbox	ajax
Using ASP.Net ajax library for cross browser Xml manipulation	ajax
Reading Image from AJAX response	ajax
JQuery AjaxUpload and PHP Max File Size Issue	ajax
Library for browser based outliner	ajax
Browser compatibility between IE6 and IE7	ajax
Secure AJAX connection / null character SSL cert attack?	ajax
how will I call the on change event of the ajax dropdownlist?	ajax
Should I just let the user hang?	ajax
MS MVC form AJAXifying techniques	ajax
jQuery and AJAX	ajax
How to get rid of jquery error	ajax
Problem with flooding menu?	ajax
AJAX and callback function	ajax
deleting session data via ajax	ajax
JavaScript - How do I call a function from a string name and pass an array object?	ajax
What are the cases when AJAX should not be used?	ajax
deleting mysql records with ajax	ajax
ajax jquery - why this extra slash?	ajax
Ajax JSON Not Returning	ajax
jQuery Cross domain ajax calls and Internet Explorer	ajax
Is it possible to cache a whole website including start html page and startup with no internet connection?	ajax
AJAX Drop Down Extender problems updating Textbox with selected index value	ajax
How do I specify multiple interfaces when registering a class in the Ajax Client script?	ajax
Ajax & Forms Question (Looking for Resources)	ajax
Are there any diagnostics tools for troubleshooting content delivery with Opera Mini?	ajax
AJAX Call to PHP script gives me 500 Internal Server Error??	ajax
How should asp.net(mvc) server return error to jquery ajax call to be caught in error callback?	ajax
Generate information based on content in RoR, any ideas on that??	ajax
AJAX constantly look for server update? Javascript	ajax
Is Asp.Net Ajax only used at presentation layer, or also at Business Logic layer?	ajax
Ajax not supported?	ajax
AJAX slowdown because of virus scanners or active network filtering?	ajax
ASP .NET MVC  Ajax link that gets executed onmouseover	ajax
Ajax File download Issue	ajax
AJAX TabPanels - How to remove panel Outline/Border	ajax
how to use ajax datepicker in vb.net 2.0	ajax
Communicating with users on other web pages	ajax
How to hide AJAX HTML Editor Bottom Toolbar	ajax
Does OpenId support Ajax login?	ajax
Whats the best, most simple ajax file uploader?	ajax
JQGrid url action not firing when using Ajax.BeginForm	ajax
AJAX request from one subdomain to another subdomain, but on the same domain	ajax
Using Yes/No Messagebox in Updatepanel AJAX.	ajax
ASP.NET Ajax script registration	ajax
Ajax Calendar always visible	ajax
Random line break showing up when .load() results display on page	ajax
Jquery ajax getting the XMLHttpRequest  state	ajax
Are there any good drag&drop AJAX web app toolkits out there?	ajax
tabIndex Attribute and AJAX	ajax
Deep Zoom in Ajax - Possible? Any examples out there?	ajax
AJAX and prediction of actions.	ajax
Do I understand Ajax correctly?	ajax
does ssl also encypt ajax posts?	ajax
"Implementing ""this is taking too long"" message with jQuery"	ajax
AJAX XML reply node value iteration	ajax
cant query json	ajax
Problems while submitting a UTF-8 form textarea with JQuery/AJAX	ajax
w3schools AJAX example	ajax
Ajax ReorderList FindControl Problem	ajax
javascript, html and browsing, is there an easy solution?	ajax
Problem with IE8 using AJAX	ajax
How to implement a AJAX function in PHP ?	ajax
UpdatePanel where Button Event does not fire.	ajax
Can AJAX calling a external webservices functions	ajax
Best AJAX TreeView	ajax
Screen scarping through AJAX and javascript	ajax
Retrieving PHP variables from an AJAX form input	ajax
Is there a way to maintain IsAjaxRequest() across RedirectToAction?	ajax
Refactor to replace AjaxControlToolkit or RadAjaxManager	ajax
"Did you try Doloto ""AJAX application optimization tool"" ? have any comments/concerns about?"	ajax
JQuery AJAX syntax	ajax
How to read all values in an array returned by a PHP file using AJAX?	ajax
Getting data back AND $POSTing data using jQuery.Ajax	ajax
AJAX ComboBox Control	ajax
ajax php variables in javascript	ajax
Is it possible to AJAX a file upload?	ajax
How can I send an array to php through ajax?	ajax
Minimum time between subsequent AJAX calls	ajax
Using update panel in AJAX a good practice in asp.net?	ajax
Ajax Binary Response	ajax
How to notify my JS client without polling?	ajax
Lightbox not working in Ajax.Updater div (prototype)	ajax
In AJAX how to retrive variable from inside of onreadystatechange = function ()	ajax
POST versus Ajax call	ajax
Ajax request with prototype - what is transport if not only responseText?	ajax
Exception thrown in a referenced .dll how do I debug?	ajax
How to avoid calling a ajax method more than once?	ajax
pass multiple parameters to jquery ajax call	ajax
Ajax authentication without letting browser pop up login dialog	ajax
issue in ajax modal pop up control when  used  witih listbox  control[which is of  a javascript]	ajax
AJAX checkbox if statement	ajax
JQuery selectors not finding class on elements in table created by an Ajax XHR in Ruby on Rails	ajax
View more link should display next 3 records instead of displaying new page	ajax
Javascript/Ajax - Manually remove event handler from a Sys.EventHandlerList()	ajax
To Ajaxify Or Not?	ajax
How to make an AJAX spreadsheet or an editable and navigatable web table/grid?	ajax
how to  insert a tr which is deleted from another table using jquery and ajax	ajax
How does codeandtheory's live search work?	ajax
Disabling interstitial graphic when using cfdiv binding	ajax
Javascript if(function_foo()) doesn't wait for function_foo() to complete	ajax
best practice for loading necessary JSON data: jquery's $(document).ready() hook? in the <HEAD> of page?	ajax
How often should a web chat client check for updates?	ajax
Function fails on the second time i call it.	ajax
How an AJAX application informs client the events fired in server?	ajax
Need Help With AJAX-Enabled WCF Services (Please Look @ System.ServiceModel in Web.Config)	ajax
Implementing Forum Live View with Ajax and JSP	ajax
Button in UpdatePanel requires two clicks to fire	ajax
Get multiple values through an AJAX query	ajax
Problem with AJAX	ajax
AJAX Beginner Security, how to secure server side files	ajax
Making Browser Back button work while using AJAX requests	ajax
Jquery Ajax Returned Array - how to handle in Javascript	ajax
Runtime error codes on AsyncPostback from AJAX toolkit	ajax
A simple Ajax + SEO solution?	ajax
Default radio button not triggering an UpdateControl postback	ajax
What are the (technical) pros and cons of Flash vs AJAX/JS?	ajax
How do I bind an ASP.net ajax AccordionPane to an XMLDatasource?	ajax
AJAX HTTPHandler not updating image	ajax
Using jQuery to grab the content from CKEditor's iframe	ajax
Understanding AJAX.	ajax
How to keep database connect alive?	ajax
bash - redirecting of stdoutput and stderror does not catch all output	bash
How do I tell if a file does not exist in bash?	bash
FTP not uploading last 4 bytes	bash
pipe bash output to two different streams	bash
How to ssh from within a bash script?	bash
"Syntax error : end of file unexpected (expecting ""fi"")"	bash
Import files directly to SVN repo without checking out first	bash
Run bash with redefined PS1 env variable	bash
Uses for this bash filename extraction technique?	bash
Split a database of mol2 molecules into N smaller sets	bash
How to implement a stdin, stdout wrapper ?	bash
Bash: How to feed a command with the multiple results generated by one subcommand	bash
command line connect to tcp port, read data, match pattern, print true or false	bash
"Bash Scripting "" [!: not found "" errors, and how to write an or statement"	bash
In a bash script, how do I sanitize user input?	bash
"How can I find out a files ""mime-type(Content-Type?)""?"	bash
Protect against accidental deletion	bash
Best way to parse command line arguments in bash	bash
bash grep newline	bash
How do I print a field from a pipe-separated file?	bash
Replace important symbolic link ‘safely’	bash
Redirect output to a bash array	bash
Kill process in bash that runs more than specified time?	bash
How to create folders using file names and then move files into folders?	bash
bash: redirect (and append) stdout and stderr to file and terminal	bash
How can I cut(1) camelcase words?	bash
Parse a dhcpd.lease File with Bash	bash
Switch user and output variable contents	bash
Using a bash script on a Mac to connect to network shares?	bash
bash: redirect and append both stdout and stderr	bash
line of bash code from .configure file	bash
Access a variable in a bash script	bash
go to path and then tar?	bash
How to manage Long Paths in Bash?	bash
bash: calling a scripts with double-quote argument	bash
Easiest way to extract the urls from an html page using sed or awk only.	bash
creating a file downloading script with checksum verification	bash
Bash variable expansion	bash
How to repace ${} variables in a *nix text file	bash
Floating Point Comparison in Shell Script	bash
How can grep interpret literally a string that contains an asterisk and is fed to grep through a variable?	bash
How to copy a file to multiple directories using the gnu cp command	bash
Send a command to a process	bash
Bash Tool To Parse CSV files	bash
Return a regex match in a BASH script, instead of replacing it	bash
Bash egrep numbers not working in case	bash
list directories containinf more than 1 file	bash
Bash or Python or Awk to match and modify files	bash
How to exit all the calling scripts in bash?	bash
To bind clear to ^l in Bash	bash
Why does wdiff not work with named pipes	bash
how to remove command line color highlighting of Vista Samba shared directories in Ubuntu?	bash
Get current working directory name in Bash Script	bash
Perform OR on two hash outputs of sha1sum.	bash
Bash and Mac OS X, open application in Space N	bash
How can I remove missing files with spaces in svn?	bash
Redirecting StdErr to a Variable in a Bash Script	bash
How to iterate over arguments in bash script	bash
Preserve ls colouring after grep'ing	bash
How to show relationships between Todo-lists?	bash
How do I prompt a user for confirmation in bash script?	bash
Compilers for shell scripts	bash
"matching a line with a literal asterisk ""*"" in grep"	bash
Bash Customizations	bash
"Detecting failure of a Bash ""export"" value"	bash
Bash Script on a Mac creates a info popup	bash
"Using linux ""cut"" with stdin"	bash
recursively add file extension to all files	bash
How to echo directories containing matching file with Bash?	bash
Bash read inside a loop reading a file	bash
Shell scripting: die on any error	bash
Bash Scripting - no output, no echo	bash
Dynamically building a command in bash	bash
Executing commands containing space in bash	bash
Using file contents as command line arguements in BASH	bash
Problem with temporary unnamed pipe in bash script	bash
Advanced directory switching in bash	bash
How to define hash tables in bash?	bash
Negate Unsigned Number in Bash	bash
Bash arrays: Need help with white space	bash
Using $@ properly (BASH)	bash
Bash script to setup a temporary SSH tunnel.	bash
Calenadr calculations in bash	bash
Question about [[]], [] and $#	bash
using the passwd command from with in a shell script	bash
How do I forward parameters to other command in bash script?	bash
How do I delete a bash function?	bash
Is [[ ]] preferable over [ ] in bash scripts?	bash
Redirect stderr and stdout in a bash script	bash
Commenting in BASH script	bash
bash script parameters	bash
Calling a python function from bash script	bash
Technique to compute next day's date from a date supplied via an arg?	bash
How to run two processes as though they were one in bash?	bash
counting duplicates in a sorted sequence using command line tools	bash
URLEncode from a bash script	bash
Bash script plugin for Eclipse?	bash
How to substitute a string in bash script	bash
Why aliases in a non-interactive Bash shell do not work	bash
How to confirm a command in every bash loop	bash
List all leaf subdirectories in linux	bash
Display characters of a variable	bash
How can I tell bash to properly esacape expanded strings?	bash
Running A Bash Script Over SSH	bash
right align/pad numbers in bash	bash
What does the amphersand indicate in this bash command 1>&2	bash
How to cut some text from string in bash?	bash
How to process file names with variables from a list in a file in Bash	bash
How to check in a bash script if something is running and exit if it is.	bash
How do I do date math in a bash script on OS X Leopard?	bash
Looking for recommendations on a good bash tutorial	bash
Is it possible for bash commands to continue before the result of the previous command?	bash
Bash: find and copy	bash
Tricky brace expansion in shell	bash
How can I redirect STDERR to STDOUT, but ignore the original STDOUT?	bash
grep-ing multiple files	bash
How do I sort a file in place using bash shell?	bash
What is the best, python or bash for selectively concatenating lots of files?	bash
How do I tell rsync to run only if the destination directory exists?	bash
Extract substring in bash	bash
Bash: Convert non-ASCII characters to ASCII	bash
Unable to forward search Bash history similarly as with CTRL-r	bash
Passing arrays as parameters in bash	bash
In the bash script how do I know the script file name?	bash
What is the Best Way to Perform Timestamp Comparison in Bash	bash
Stop echoing ^C to terminal	bash
How to upload (FTP) files to server in a bash script?	bash
Validate Emails with Bash	bash
How do i synchronize (lock/unlock) access to a file in bash from multiple scripts?	bash
Can a bash function be used in different scripts?	bash
bash command to repeatidly emulate keypress on a proceess	bash
using bash to get revision number from subversion	bash
What's wrong with my bash array?	bash
how to use ping in a script	bash
Bash: Copy a folder full of files and folders to an external hdd, but only if there is enough space to complete the copy.	bash
Control Processes Started by Bash Daemon	bash
Exit Shell Script Based on Process Exit Code	bash
Mutable list or array structure in Bash? How can I easily append to it?	bash
how to chop last n bytes of a sting in bash string choping?	bash
how do I paste text to a line by line text filter like awk, without having stdin echo to the screen?	bash
Monitoring bash script won't terminate	bash
a sufficant way to show logs in a graphical interface using whiptail bash	bash
How to use a pipe in a foreach statement	bash
bash script to watch a folder	bash
Can't seem to use bash -c option with arguments after the -c option string	bash
How do you use shell script variables as arguments to sed?	bash
basics of using cut awk grep and sed...	bash
Looking for book on Bash scriping	bash
How to filter out a set of strings A from a set of strings B using Bash	bash
Need to write a program to sanely configure a login shell	bash
lookup Data in Excel	excel
"Excel Prefixcharacter in C# with OLEDB causing ""Data type mismatch in criteria expression"" error on UPDATE"	excel
Accessing a VSTO application-addin types from VBA (Excel)	excel
Excel: Formula to reference an entire pivot table?	excel
Array Formulas in Conditional Formatting of Excel XML Spreadsheet files?	excel
Copy method fail due to memory	excel
Round function in Excel, worksheet function vs VBA	excel
Ways to deal with arbitrarily large sets of an arbitrary number of items in Excel	excel
Retreiving Values From Excel Merged Columns	excel
excel macro that checks every row has unique or blank number	excel
How do I change the indenting for Excel's XML Data Export?	excel
Using excel as UI without VB	excel
Setup an Excel template so calculations are not dependant on a specific number of columns / rows	excel
How do I import an excel spreadsheet into a Visual Basic Application	excel
How to crack an Excel workbook that looks up values?	excel
How to get google page rank and number of searches in excel sheet	excel
Excel: What's the best way to get the value of a Relative Row but from a Fixed Column?	excel
Sql Server to Excel via a Web Service	excel
Excel: Putting together two different complex formulas (Unique distinct list & Split)	excel
Cancel External Query in Excel VBA	excel
Converting OOo macros to Excel macros	excel
problem with Excel automation function	excel
VBA code for SUMIFS?	excel
Simulate string split function in Excel formula	excel
Smoothing formula for ChartType = xlXYScatterSmoothNoMarkers	excel
How to insert the symbol 'Infinite' in Excel programmatically?	excel
Excel and IE7 - Prevent IE from opening Excel files	excel
Is it possible to add VB to an Excel sheet from POI?	excel
Rendering Excel from browser	excel
"MS Access 03 - muliplte ""ifs"" in one field of update query's criteria??"	excel
Breaking a cell if it contains a newline character	excel
Excel 2007 UDF: how to add function description, argument help?	excel
How do you close Excel com object and save the work?	excel
how to get weights of numbers in excel in this problem	excel
generating nicely formatted excel files in ASP.net without having Excel on server	excel
Read excel sheet in c#.net	excel
how do i multiply two cells by their names?	excel
How can I look for the duplicate values in a certain field in a spreadsheet ?	excel
is it possible to display a Google Earth map INSIDE Excel?	excel
Excel 2007 - Catch open command bar button event	excel
Excel VBA: Identify invalid characters in text based cell	excel
How can I get back a previously created Excel ListObject?	excel
Merge Excel Files Into One	excel
How to remove Excel VBA code modules when spreadsheet opened/closed	excel
"Excel Automation: Open existing Excel file as ""new"""	excel
Excel: Create a new sheet for each row	excel
[Excel] Populate list via a bi-Condition	excel
hyperlink to a sheet in excel	excel
Using NOT LIKE in Filter property of VBA recordset	excel
Language/framework to write Excel spreadsheets, webbased	excel
Programmatic mail-merge style data injection into existing Excel spreadsheets?	excel
pass sheet to a function (excel vba)	excel
Saving different csv files as different sheets in a single excel workbook	excel
Excel triggered macro	excel
Excel VBA - Insert a Row to a Specific Set of Columns	excel
Shared Worksheet with Macros in Excel 2003	excel
Modeless MsgBox, Error trapping, .Find	excel
Making Excel functions affect 'other' cells	excel
Understanding / Modeling forumals from Excel.	excel
Excel: Changing right click menu above autoshapes.	excel
Equality with zero in Excel	excel
How do I create a filter for Microsoft Excel?	excel
Excel 2007 - Sheets.add from template file loses formatting	excel
Excel Word Wrap Problem after Macro	excel
How to get Excel Integration in TFS to remember formatting?	excel
SQL behind an external data query in Excel	excel
Help with excel automation addin	excel
XlsIo DateTime Incorrect by about 4 years	excel
How to check for empty array in vba macro	excel
Adding Ribbon support to Excel COM Addin	excel
Set a type in VBA to nothing?	excel
Workarounds to avoid trying to conditionally protect cells in a shared workbook	excel
Excel query table still works after deleting File DSN, how is that possible?	excel
How to save data on excel xls file using perl?	excel
"Excel - ""File Not Found: VBA6.DLL"""	excel
SpreadsheetGear fonts look blurred compared to Excel	excel
Spreadsheet: Count Repeated Values In A Column	excel
Expose VSTO functionality to VBA w/o local admin	excel
Converting XLL addin functionality to a native VB module : Problem refreshing formulae	excel
Counta behavior in countifs	excel
VBA changes Excel 2002 -> Excel 2007	excel
excel with an SAS engine	excel
"MS Excel 2003 VBA - Is there a way to define a group of shapes/object into a ""group"""	excel
How to zero fill a number inside of an Excel cell	excel
Excel formula to get ranking position	excel
How can an Excel Add-In respond to events in any worksheet?	excel
How to modify existing excel file using PHP?	excel
How can I format bytes a cell in Excel as KB, MB, GB etc?	excel
Running a macro in excel	excel
What do I need to do to make Excel access a Web Query via HTTPS?	excel
Setting date cell format in excel xml	excel
How do I prevent Excel from rendering the spreadsheet as my macro calculates it?	excel
Return value of nth or last match	excel
Excel workbooks produced by POI don't work when linked	excel
How to import .class file in jsp page which is not in standard library?	excel
Inserting a jfree chart in excel using jsp	excel
How to keep Excel interop from stealing focus while inserting images	excel
In Excel how to create multiple rows from a single data row	excel
Create a multi-tabs Excel file	excel
VBA long overflow	excel
Can this be done using excel macos?	excel
Automatic hyperlinks in Excel?	excel
Programmatically extract data from an Excel spreadsheet.	excel
Excel VBA Macro: create a chart from CSV?	excel
How do I create a status dialog box in Excel	excel
Is there a native excel class which allows a range to be copied and sorts/filters applied?	excel
"How to capture the ""Print"" button from the menu bar in a macro"	excel
Process for updating Excel add-in?	excel
Array Constants in Excel	excel
Excel Embeded If Statements	excel
How to stop Excel to prompt to reopen a workbook.	excel
Excel: parse text as formula	excel
Excel 2007 - selecting multiple non-contiguous cells within one column.	excel
How do you test that a Range in Excel has cells in it?	excel
Excel as database frontend for several concurrent users - doable?	excel
How do you get Excel to refresh data on sheet from within VBA?	excel
[Excel VBA]How to cast a shape object?	excel
Excel Conditional Content/Formatting for Print vs. Screen and Page Breaks	excel
How to get the size of a range in Excel	excel
excel time serial back to text	excel
Using a formula from another column in Excel	excel
How do I make a burn down chart in Excel?	excel
Web scraping in VBA and Excel	excel
Copy Excel worksheets, macros, and graphs from one workbook to another, moving links to the new workbook	excel
Uninstalling Excel add-in using VBScript	excel
"What is the most efficent way to get a Range ""set difference"" in Excel Automation?"	excel
Excel problem with deleting CustomProperty in Korean	excel
How to find and select multiple rows with macro (excel) ?	excel
How to show long numbers in excell ?	excel
Excel Range Format: Number is automatically formatted when Range::Value2 is set	excel
substituting an Excel worksheet for an Access database	excel
Office 2003 interop problems, interface, method not found.	excel
How do you add two COUNTIF equations together?	excel
Excel Range describes a group of adjacent cells.  When several groups of non-contiguous cells are selected, how do you get them all from Worksheet.Selected (range)?	excel
0x800a03ec when calling Select on an Excel range (IRange). Range was returned from the worksheet's usedrange.	excel
C# and Excel files	excel
Excel xth letter of the alfabet	excel
Excel VBA merge multiple columns into one on separate rows	excel
Excel/VBA to check if a row exists	excel
How to call a long-running external program from Excel / VBA	excel
Bind macro to excel cell onclick?	excel
excel file too big , which format to convert to imporve processing time in scripting	excel
Delete a file after user download prompt	excel
Importing Excel data to a already established SQL DB visual basic	excel
Creating tables for copy from Word to Excel	excel
Can I run Excel from a .cmd script with all macros enabled?	excel
How to use dll's in the same directory as an excel file	excel
Excel:  combobox listfillrange property pointing at a formula-based named range; combobox with a linkedCell, equals bugs	excel
Excel ODBC and 64 bit server	excel
Can I edit an excel file from a browser using POI?	excel
When should I dispose of a data context	linq
How do I project to a dictionary with a custom type using Linq to SQL?	linq
Apply function to all elements of collection through LINQ	linq
Group By Multiple Columns - LINQ	linq
linq to sql:  join multiple columns from the same table	linq
Add incremented property to IEnumerable by group using LINQ	linq
How do you transform a Linq query result to XML?	linq
Bind Exclude Asp.net MVC doesn't work on LINQ Entity	linq
Automatically add some Where clauses to a Linq Expression Tree	linq
Is there Cache with Linq query support	linq
Linq Sub-Select	linq
Linq: How to Assign to Related  Entities ?	linq
Determining and arranging items on lenght  in IEnumerable<T>	linq
Linq to Entities and concatenated properties	linq
Building up a LINQ query based on bools	linq
How do I get the next item in a subset of an ordered table using linq?	linq
How to use Linq To Sql to count the idle working duration in a day?	linq
Is there something wrong with my System.Xml.Linq library?	linq
Linq to SQL: order by value in related table	linq
LINQ to SQL and Data Projection, MVC	linq
LINQ - Return Value From Field With A Max Value if No Rows Found	linq
Does LINQ use DataRelations to optimize joins?	linq
Select Multiple Fields from List in Linq	linq
linq orderbyAscending?	linq
Linq Newbie. Can I write this Linq query more concise?	linq
Advanced multiple join in subquery using LINQ	linq
When using a LINQ Where clause on a Dictionary, how can I return a dictionary of the same type?	linq
How do I build a Linq Expression Tree that does this?	linq
Linq to SQL - how to dynamically filter by columns not in select	linq
How does Linq work (behind the scenes)?	linq
Using LINQ to SQL and chained Replace	linq
What are the advantages of LINQ?	linq
Use LINQ for arbitrary sorting	linq
LINQ to XML Newbie Question: Returning More Than One Result	linq
if exists statement in sql to linq	linq
Is LINQ Slower Than Calling Sprocs?	linq
Linq to Sql Deferred Loading	linq
LINQ to entities - Building where clauses to test within a many to many relationship.	linq
LINQ Syntext Sequence	linq
Is LINQ to Everything a good abstraction?	linq
Populating child collection property with LINQ sub-query	linq
Using the All operator	linq
How do you count the words in an array of strings with LINQ?	linq
how to do subquery in LINQ	linq
Determining scope of a MemberExpressions target	linq
linq: multiple order by	linq
how to write string for include for linq query?	linq
Getting rows from a SQL table matching a dictionary using LINQ	linq
LINQ performance - deferred v/s immediate execution	linq
EBNF to fluent interface	linq
Query Microsoft Access MDB Database using LINQ and C#	linq
LINQ, ASP.net mvc and joins	linq
How much overhead does 'Update Check' have for LINQ UPDATES	linq
IQueryable efficiency	linq
Linq to NHibernate vs. ICriteria	linq
LINQ COUNT on multiple columns	linq
How can I use linq to sort by multiple fields?	linq
Which is the best book out there to learn Linq, including Linq to Entities?	linq
Do LINQ queries have a lot of overhead?	linq
Need help with LINQ query and ASP.NET MVC?	linq
How can I query two databases and combine the results using LINQ?	linq
LINQ to Entity Duplicate Record Issue	linq
Why always return null when call the method IQueryable.FirstOrDefault()?	linq
how to put linq to sql in a separate project?	linq
expression trees linq get value of a parameter ?	linq
Ignore read-only class properties when using DataContext.ExecuteQuery<T>	linq
Non generic IQueryable Enumeration Problem	linq
Sorting MultiValue data numerically OR alphabetically - LINQ to SQL and C#3.	linq
Read attributes values with linq	linq
How to Re-Order Evaluation of this Linq Scenario	linq
Is there a way to write a group by query in LinqToSql grouping not on a scalar value?	linq
How do I get the max data size of every column in an IQuerable using LINQ	linq
linq sql error : the text data type cannot be selected as distinct because it is not comparable.	linq
How to get an array of distinct property values from in memory lists?	linq
LINQ with generic Predicate constraint	linq
How to add collation to Linq expressions?	linq
Linq to XML - way to write binary Data into XML	linq
Linq query, how to build nested objects from single table	linq
Querying a timestamp column from LINQ to SQL	linq
How to work with dataset's datarelation in linq?	linq
Adding Nodes to Tree via LINQ creates query operator not supported during runtim	linq
How do you extend Linq to SQL?	linq
Is yield useful outside of LINQ?	linq
Linq for NHibernate and fetch mode of eager loading	linq
refactoring the OrderBy expression	linq
What do they mean when they say LINQ is composable?	linq
LINQ to XML Newbie Question	linq
Linq and retrieving primary key	linq
LINQ statement where result count is used in expression's condition	linq
Using reflection to address a Linqed property	linq
linq to xml and ViewList problem	linq
sequenctial autogenerated Id with help of linq	linq
Can I select multiple objects in a Linq query	linq
Order a parent object by a child's property in LINQ	linq
Update SubmitChanges() - does not update.	linq
linq: counting items in subsets of queries	linq
asp.net mvc add column to the database - how do i update the dbml file	linq
"Does Linq has ""Difference"" ?"	linq
LINQ to SQL	linq
Difference between Expression.Call overloads?	linq
Linq and comparing two date columns	linq
How to use Linq to set attributes based on counter	linq
insert 2 table in single query in linq	linq
Applying LINQ to Objects Group By and Sort By to generic List<T> (C#)	linq
LINQ to SQL Lookup table? Join perhaps? I'm lost... ;/	linq
How do I find similar column names using linq?	linq
Pros and Cons of LINQ (Language-Integrated Query)	linq
What options do I have for LINQ projections?	linq
Linq To Sql - ChangeConflictException not being thrown. Why?	linq
How to name fields using Dynamic Linq?	linq
LINQ Query for Controlling some item.	linq
Filter linq list on property value	linq
Linq Help. int.Contains and int == iqueryable doesn't work.	linq
Linq to Xml: selecting elements if they're contained within an IEnumerable<XElement>	linq
Dynamic Linq To Sql With ComboBox and Column.Contains	linq
How do I use subquery, groupby, max, and top in single linqToSql statement?	linq
Selecting columns in DataLoadOptions	linq
How to Query A DataGridView Using Linq	linq
Why Linq Preview for VS2005 doesn't create objects?	linq
Adding index field to LINQ List <T> results using C#	linq
LInq - querying child collections	linq
Using LINQ to Get Sum of a List with custom objects	linq
Paginated search results with LINQ to SQL	linq
Need help in resolving error in predicates for And operator in LINQ	linq
Read a specific Element Value based on a specific Attribute in Linq?	linq
LINQ - Select all children from an object hierarchy	linq
LINQ to Entity Framwork: return sorted list of related rows	linq
linq help - newbie	linq
ExpressionType.Quote	linq
Linq: IsNot in Object collection	linq
"What is the best way to optimize or ""tune"" LINQ expressions?"	linq
Your Favorite LINQ-to-Objects Queries	linq
Is LINQ (or linq) a niche tool, or is it on the path to becoming foundational?	linq
Linq to object: ToList can not convert to gerneic list	linq
Is linq a cursor?	linq
Deleting Database in Linq	linq
Which LINQ syntax do you prefer? Fluent or Query Expression	linq
sorting variable multidimensional arrays	linq
Silverlight 3 - RIA Services and LINQ	linq
Linq + NHibernate: is it production ready?	linq
Use LINQ to concatenate multiple rows into single row (CSV property)	linq
How to limit a LINQ left outer join to one row	linq
Joining tables in LINQ/SQL	linq
LINQ inner join betwenn Enumerable and DB Table	linq
How scalable is LINQ?	linq
Simple tutorial for Linq	linq
Nested Linq crashes intellisense	linq
LINQ -  Is it possible with dynamic LINQ to dynamically speficy the from clause.	linq
What would this sql query (w count and group by) look like when translated to linq?	linq
DateTime, DateTime? and LINQ	linq
Qt best choice for animation on embedded	qt
How can I set the path + filename in Qt Designer's property box?	qt
Resources to learn QT/Embedded 4.5 ?	qt
Minimal Qt executable-size	qt
Cannot integrate custom widgets dll into Qt designer	qt
Strange QT application behavior	qt
WCF service with Qt?	qt
64-bit Qt and Postgres in Windows	qt
Best way to parse HTML in Qt?	qt
Qt ClickToFlash	qt
Mapping widget for Qt	qt
Reattaching to an orphan process in QT	qt
Java Swing or Java Qt?	qt
Laying out overlapping rectangles	qt
How to make QLineEdit expand inside QScrollArea	qt
How to create a Qt window behave like a message box ?	qt
Why is in Qt child objects are allocated in Heap?	qt
QSignalMapper and original Sender()	qt
Accessing the child UI elements in a Qt UI	qt
Qt - how to detect what application is in focus	qt
C++ Qt: bitwise operations	qt
undo redo with an auto delete mechanism	qt
Getting MouseMoveEvents in Qt	qt
In Qt, create a table with an blank editable row	qt
Possible to output to .doc format using Qt?	qt
Qt Widget being resized twice upon initialization?	qt
good combination of a c++ toolkit/library, cross platform db (not necessarily sql)	qt
Libqxt under Qt Creator	qt
Set parent's status bar text?	qt
How to map a resource file in QT 4.5?	qt
QTableView - what signal is send when user selects a row by clicking to it?	qt
Best way to add python scripting into QT application?	qt
Create database in QT	qt
Python Qt: embedded html bug?	qt
Compiling Qt app agains latest VC++ 2008 runtime	qt
Do I have to delete it? [Qt]	qt
What is the best place to start learning Qt?	qt
QTCreator's integrated form editor won't load custom widget plugins (Designer does)	qt
Resizing Mfc dialog with embeded QWinWidget	qt
How do I determine if the item is selected or not in the paint() function of QItemDelegate?	qt
Qt +hiding window after startup	qt
Properties editor design pattern?	qt
what is this widget called?	qt
Is there a test suite for verifying a QT port?	qt
Access to QTabBar instance	qt
Best Qt Widget to use for properties window?	qt
how to sort a QTableWidget with my own code?	qt
QtWebKit, QWebElement::setPlainText() problem	qt
Qt: Square constraint on window resize	qt
Qt::What needs to be included in the configuration to use dbus?	qt
QT: problem with creation of C++ library	qt
Does qt 4.5 have any skins?	qt
Does the isSelect-method of QSqlQuery return true when a stored procedure is executed?	qt
Deploy Qt+Boost application on a Mac and Windows.	qt
How to create a subdirectory for a project in qt-creator?	qt
Visual Studio or Eclipse - which one is better for Qt on Windows?	qt
calling Qt's QGraphicsView::setViewport with a custom QGLWidget	qt
Creating GUI application completely in QtScript, what is your opinion?	qt
QT4: Is it possible to make a QListView scroll smoothly?	qt
Is it possible to run q Qt Symbian application in the background and interact with the homescreen?	qt
QDockWidget - remove handle	qt
Is there an QPointer specialization for boost::bind	qt
Qt doesn't find QStackedWidgets' slot setCurrentWidget	qt
most effective row removal strategy for QStandardItemModel	qt
Qt: Erase background (Windows Aero Glass)	qt
fit-to-width for a QWebView	qt
Qt single EXE with lgpl?	qt
How to send keypresses from qt application to libvlc	qt
Is there an easy way to customize a QProgressBar?	qt
QT: Context menu (QMenu) reference from the QTableWidget.	qt
Disable drag/drop in QtWebkit	qt
How to install a Windows service using Qt?	qt
Hiding a QWidget on a QToolbar?	qt
desktopdock or stardoc in Qt	qt
Compilation of QT Property Browser	qt
Custom dock area using Qt 4.4	qt
is there a performance difference between QList<QList<int> >myList; and int ** myList;  ?	qt
What happens when I call QWidget->close()	qt
For Qt 4.6.x, how to auto-size text to fit in a specified width?	qt
How to know a QTreeWidget selected item?	qt
Run Qt application on startup as Linux daemon	qt
QTcpSocket in QThread	qt
Beneficial to limit scope of Qt objects?	qt
Oversized Qt Fonts on OSX	qt
Where can I store a QAction(Group) ID?	qt
Argument type for Qt signal and slot, does const reference qualifiers matters?	qt
PCRE format to QRegexp format	qt
why we integrate Qt with visual studio	qt
Which Qt DLL's should I copy to make my program stand-alone?	qt
including Qt headers in DLL	qt
Can QSignalMapper be used to re-emit signals with multiple parameters?	qt
How to make Qt work when main thread is busy?	qt
How to compile a simple Qt and c++ application using g++ on mac os x?	qt
Cross Platform C library for GUI Apps?	qt
QFileDialog: adding extension automatically when saving file?	qt
How to change a QPushButton icon when it has focus?	qt
How do I auto-adjust the size of a QDialog depending on the text length of one of its children?	qt
help with mixing widget painting and UDP data transfers in a multi-threaded context	qt
Qt: Is is possible to get the QScriptEngine from QWebFrame?	qt
How to set selected filter on QFileDialog?	qt
QT Background Color	qt
QT creator/qt embedded widget demo problem	qt
Qt QSystemTrayIcon not sending activated signal	qt
Reading/writing QObjects	qt
QX11EmbedContainer and QProcess problem...	qt
How  do I resize QTableView so that the area is not scrolled anymore	qt
Keep a stream from fstream open through member functions	qt
Removing custom widget from QVBoxLayout	qt
Trouble with progressbar in QT	qt
How do I respond to an internal drag-and-drop operation using a QListWidget?	qt
Compiling Qt libraries to run with Visual Studio 2008, why does nmake fail?	qt
How do I embed a binary executable (to be executed at runtime) in a QT program?	qt
Add QObject in the combo box of Qt	qt
QtPython: removeChild/addChild QGroupBox	qt
QtAbstractAdaptor vs. QtAbstractInterface	qt
How to create artificial nodes in QAbstractItemModel for QTreeView	qt
Qt: set a default cursor for an application	qt
Qt library event loop problems	qt
Signals dont get emitted	qt
can I use breakpoints with try catch statements with qt creator?	qt
In Qt how do I get a button press to set a spinbox to a certain value?	qt
qt configuration on windows	qt
How good QT under LGPL for commercial applications?	qt
Outlook style toolbar in Qt	qt
QVariant and qRegisterMetaType question	qt
QT sqlite deploy exe	qt
How to show another window from mainwindow in QT	qt
Adding attributes to Q_PROPERTYs	qt
Animations with full alpha in QT 4.4?	qt
qt soap client + ASP.net Web service	qt
Should I use Delegate Classes if I want items to be edited using a dialog in Qt?	qt
QT MySql connectivity using Windows XP, Qt Creator 4.5.2(windows 32 bit)	qt
QMenu* << QAction* -- Help Me Write A Global QMenu Insertion Operator	qt
Qt vs WPF/.NET	qt
QtCreator 1.3, Qt 4.6.2 and build problem with cmake on windows	qt
How can I implement Google Maps-like tile scrolling in Qt?	qt
Measuring text width in Qt	qt
Drag&Drop problem in a TreeView Qt	qt
exception generated with qtconcurrent and calling QTime:currentTime	qt
QT / thread event loop QTimer/Mysql queries	qt
Qt4: QTableView mouse button events not caught	qt
Qt 4.5.3 QEvent::EnterEditFocus	qt
Modifying Qt core components/widgets, best practices?	qt
QT & UDP-Socket	qt
Qt::How to lower the text in a qspinbox	qt
QT4: Transparent Window with rounded corners	qt
How to create a tray icon with custom image using QT?	qt
Qt image format plugins	qt
Implement ManualResetEvent and AutoResetEvent	qt
QFontMetrics::leading() returns 0	qt
Drupal Help - Warning: Unresponsive Script - Everytime Goes into or out of Block Edit Mode	drupal
Drupal Token Examples of Usage	drupal
Drupal: last core version update. Risky, if I don't update it ?	drupal
"Provide user with ""change permissions"" link on content type?"	drupal
upgrading drupal 4.7 to 5.2	drupal
Customized Drupal with pre-installed modules	drupal
Drupal Ajax: Passing values by url vs data param	drupal
Team working on Drupal - Tips	drupal
adding onsubmit to drupal login forms	drupal
Expanding mySQL query to include more content	drupal
Drupal - Remove RSS	drupal
Migrating from Drupal to Rails - Routing	drupal
How does one create product collections in Ubercart?	drupal
Only show a view on a certain content type in Drupal	drupal
Custom comment form in CCK template	drupal
Disabling /node view and other hidden views in Drupal?	drupal
Create WebApplication with Drupal: development steps...	drupal
Drupal PHP pages without having a DB Query?	drupal
Drupal field values and longtext	drupal
"Drupal 6: How do I only call up ""events"" by upcoming date?"	drupal
Add a Drupal menu item with a hard coded path to a view that accepts arguments?	drupal
Calendar + Events in Drupal 5	drupal
Open create content form modal and refresh view display in Drupal	drupal
Drupal Photo Gallery Tutorial	drupal
Rearrange ordering of blog posts vs content block?	drupal
Drupal State Machines, usage and alternatives	drupal
Cache: How to exempt just one block	drupal
Removing <ul> bullets via CSS	drupal
Drupal hook priority	drupal
Is there a way to rewrite a url to go to a file stored in the filefield of the node	drupal
Drupal OG Views: cannot create view of all groups of which I am *not* currently a member	drupal
How do I move the tag section below the content in Drupal 6?	drupal
drupal cck image_field and imagecache	drupal
Drupal: Access $profile from a block	drupal
Drupal: module to implement credit system	drupal
Front page Featured Section	drupal
Preserving data integrity in Drupal:	drupal
Is Drupal ready for the enterprise?	drupal
Good drupal books/resources for programmers/developers?	drupal
Using Drupal Views VS templating	drupal
Drupal paths in themes	drupal
Drupal vs OSCommerce	drupal
"How can I categorize the content types on the Drupal ""Create content"" page (/node/add)"	drupal
Adding more information onto the $user object in drupal?	drupal
Drupal: Creating anchor only link with l()	drupal
Drupal - showing forums on the left side bar	drupal
Drupal - displaying the title of the node within a block	drupal
Drupal Array of Inputs	drupal
Download Drupal Documentation?	drupal
Blank arguments in Drupal view not working	drupal
Drupal incorrectly espaces tags in javascript	drupal
How to map old paths to Drupal paths	drupal
Any quirks I should be aware of in Drupal's XML-RPC and BlogAPI implementations?	drupal
DRUPAL: adding CCK image fields to other CCK fields	drupal
Hide Drupal nodes from search.	drupal
Drupal search module has suddenly stopped working, how do I fix this problem?	drupal
Is there a Drupal module for Forms with powerful CRUD style behaviour?	drupal
Change owner on publish node in Drupal	drupal
drupal how to limit the display results  of the calendar view	drupal
Upgrading from Drupal 6 to Drupal 7: best programmer's practices?	drupal
Modificate content profile form to show checkboxes in the matrix	drupal
Move Nice Menus to Just below the Title	drupal
Add another node display (like teaser, full node) to Drupal	drupal
Drupal - Set default value in hook_form_alter?	drupal
Drupal to Drupal Migration	drupal
is ther a drupal function to jump out of the page rendering process and return a page not found?	drupal
Drupal: displaying a language switcher only when the content is translated	drupal
Upgrades to Drupal in production	drupal
Solving drupal database entry dependancy problem?	drupal
What PHP framework to choose for a Senior Project	drupal
Drupal workflow action access integrated with taxonomy access control?	drupal
Drupal - General means for finding templates?	drupal
Asigning specific menu administration rights for roles in drupal	drupal
Hooking user registration in Drupal	drupal
Which one to use for payments on Drupal website, LM_Paypal or Ubercart ?	drupal
Drupal CCK add another item callback	drupal
Is it possible to script for data entry with Drupal?	drupal
Drupal Multi-language: Simple strings not translated	drupal
custom form with Drupal - CCK and simple module - what next?	drupal
Node relations in Drupal Views	drupal
Hide link to a view if it's empty	drupal
Sorting a Drupal field View by updated time.	drupal
Drupal research strategy (custom or ready module)	drupal
Drupal node form customization	drupal
Implementation of Drupal Memcache in custom modules	drupal
Drupal shared tables, but from another database	drupal
eCommerce Drupal	drupal
Drupal: Exposing module data to Views2	drupal
drupal  how to refresh the page when the content is created in the popups	drupal
Advanced search with Drupal (Views and CCK)	drupal
Missing/disappearing Drupal tabs	drupal
Content Taxonomy along with Conditional Fields	drupal
drupal 6 can we write a php file in drupal which changes the headers	drupal
"Is it possible to set a module's checkbox to ""readonly""?"	drupal
Drupal Query builder	drupal
TinyMCE adds <pre> tag when inserting from Word	drupal
Add a function to OnLoad in Drupal	drupal
drupal, rules, flag, date	drupal
Drupal Menu System - Outputting a Tree One Level Down	drupal
drupal: auto-generate video thumbnails	drupal
Drupal Batch operation page fails with my theme.	drupal
How to surround a Drupal view with some tags?	drupal
drupal multiple node forms on one page	drupal
Drupal question: Views, arguments and nodequeues	drupal
How to perform Request destination in user page	drupal
Drupal Custom CCK field with multiple child fields	drupal
drupal node update permission once a week	drupal
DRUPAL: is it safe ? / cron.php ?	drupal
Stop a custom submit button from firing the form validation on a CCK form	drupal
Grouping non-cck fields in Drupal?	drupal
Adding Event to YUI Rich Text Editor	drupal
How to serve files in Drupal without using links?	drupal
[Drupal] How do i give a specific user editing rights to a specific node?	drupal
Cannot see anything from #prefix and #suffix fields	drupal
drupal - add select/option list to a form	drupal
Drupal import Tweets from Twitter as Nodes	drupal
How to remove nodes from Views in drupal 6	drupal
Using Node Data after Node is Created	drupal
Drupal automatic glossary for specific terms	drupal
Drupal: Getting user name on user account page without breaking performance	drupal
Drupal How to see document attached to Node for anonymous users	drupal
calling user_save from within hook_init failing on Drupal6	drupal
Drupal: best practice to arrange various Drupal entities into one site /subsection	drupal
Drupal Theming - Background images without dimensional constraints	drupal
drupal taxonomy	drupal
Adding sorting to a view on Drupal?	drupal
Drupal - Lightbox -> iframe node displaying entire website with views	drupal
Un-Published items showing in Drupal search results (google search appliacne)	drupal
Drupal: Custom Content Type validation	drupal
Fix Size of Login Box in Drupal Theme	drupal
How would the conversion of a custom CMS using a text-file-based database to Drupal be tackled?	drupal
Getting data from sharepoint into drupal	drupal
display vacabularies in drupal 6	drupal
Creating Drupal taxonomy terms from code?	drupal
How can we add an iframe into the contact page in Drupal 6	drupal
Calling custom PHP inside Drupal	drupal
Drupal: cck taxonomy field with depth filtering	drupal
Drupal's SimpleTest not creating copies of custom tables	drupal
Where is the best place to put a DB query in drupal?	drupal
Drupal module for webmaster block management?	drupal
At what point do you need to be a programmer to work with Drupal?	drupal
Drupal: Create custom search	drupal
batch create users?	drupal
How can I associate many existing files with drupal filefield?	drupal
Drupal administration theme doesn't apply to Blocks pages (admin/build/block)	drupal
shut off htmlpurifier upgrade message	drupal
Drupal: How to return only content and not the whole layout?	drupal
Adding Zend Framework to php.ini include_path causes Drupal site to go blank	drupal
Drupal - Customize a create content form for a certain content type	drupal
How do you set up drupal menues?	drupal
How Do I Serve a File Through JSMin PHP Script With Correct HTTP Caching (using .htaccess?)	apache
How can I make the -f flag apply to directories with a trailing slash?	apache
How to set up virtual hosts properly on a windows machine using Zend Community CE ?	apache
Is it possoble to obtain the hostname only from HTTP_REFERER with mod_rewrite?	apache
mod_rewrite adding unwanted file extension	apache
How to make apache slow and unreliable?	apache
Is it possible to redirect traffic from page that doesn't exist to existing page with .htaccess?	apache
Is it safe to put database file in htdocs?	apache
Why do I have to copy the libmysql.dll to the apache/bin directory to get the PHP extension to load properly?	apache
"What is the cause and how to fix 503 errors with this in Apache error_log: ""Broken pipe: ajp_ilink_send(): send failed"""	apache
Apache and mod_rewrite: Redirect domain to subdirectory	apache
Is there a realtime apache/php console similar to webrick or mongrel with ruby on rails?	apache
"Apache configuration help -- Why are different processes ""in"" different time zones?"	apache
RewriteRule in .htaccess not working	apache
i can do http://bookroom and smb://bookroom... to test my local site or use shared resources.  anything i don't know yet?	apache
Apache2 + RewriteMap + Python -- when returning 'NULL', apache hangs	apache
How to ensure that Apache always serves a single page via HTTPS?	apache
huge svn checkout makes apache (dav_svn) consumed all memory on server - any tips?	apache
Make apache automatically strip off the www.?	apache
Apache LogFormat IP Address	apache
How to password protect files (images, video, zip) dynamically from public and allow access to members only?	apache
Updating Files on Apache	apache
Restrict access using SSL certs	apache
Webserver Log Analysis	apache
Source install Apache 2.2.13 + PHP 5.3 + Snow Leopard	apache
What access does Apache 2.0 need in Windows Server 2003 in order to start as a service?	apache
Apache Webserver & JBoss AJP connectivity with https	apache
Releasing under license: Do all files need the copyright statment?	apache
How do I ignore a directory in mod_rewrite?	apache
adsense iframes create new sessions on my server	apache
To allow only localhost in Apache's 000-default	apache
How to set REMOTE_ADDR in apache before php is invoked	apache
Do I have to duplicate the Virtualhost directives for port 80 and 443?	apache
Integrating Apache and Restlet server like Apache and Tomcat	apache
Switching from Tomcat to Glassfish	apache
Generic htaccess redirect www to non-www	apache
Apache Mod Rewrite (.htaccess)	apache
How can i see my apache rails server from other computers on my local network?	apache
defer processing during apache page render	apache
Apache Perl http headers problem	apache
Running PHP without extension without using mod_rewrite?	apache
Apache / htaccess rewrite - From domain to subdomain	apache
Rewrite rule-- If incoming request is not consist of certain characters then rewrite to other URL	apache
Apache Rewrite and variable	apache
Close client connection preaturely with apache/mod_perl	apache
Disable Apache 503 response when Tomcat is down	apache
"rails - ""apache cannot run because another program is using its port"""	apache
How to make Apache/mod_python process to collect its zombies?	apache
Using Apache and mod_ext_filter, need to dynamically replace values of static file based off of query string.	apache
Assistance with APACHE www.conf file correctly matching location?	apache
Can i limit apache+passenger memory usage on server without swap space	apache
Apache: multiple ../ in query string = internal server error (error 500)	apache
.htaccess folder protection	apache
"Configuring Apache to route ""GET /user/foo"" to /user/GET.php and ""PUT /user/foo"" to /user/PUT.php"	apache
Auto-redirect requests from /dirname to /dirname/	apache
Apache Tomcat and Ruby	apache
How many connections/how much bandwidth can Apache handle?	apache
Starting Apache service with a variable that can be later accessed via PHP?	apache
Apache crashes when php_apc extension is turned on when using symfony?	apache
Parse the HTTP_COOKIES string from Apache for use in #if clause	apache
Applying mod_rewrite rules AFTER DirectoryIndex is applied	apache
How to disable all apache virtual hosts?	apache
how to code a PHP function who will check whether the mode of Apache is on safemode or not ?	apache
Adding slashes to the end of directories + more (htaccess)	apache
WebGate Configuration Problem	apache
Apache mod_rewrite only if request does not start with '/THEMES/'	apache
Setting the umask of the Apache user	apache
How to create a custom 404 page for my Django/Apache?	apache
Is there a way to get Apache to serve files with the question mark in their name?	apache
Redirecting from pubilc_html to public_html/new/	apache
What is the purpose of (Apache) putting inode into an ETag?	apache
Performance effect of enabling apache response time log directive	apache
What is the best way to do server-side output caching PHP?	apache
Is the Timeout directive of Apache overrideable in htaccess or inside of a <VirtualHost>?	apache
Using relative URLs with mod_rewrite	apache
How to encode special characters using mod_rewrite & Apache?	apache
SSLVerifyClient not asking for certificate	apache
Failed to get separate instances of a class under mod_python	apache
How can I store my Rewrite Rules in a database?	apache
Redirecting /media/* to /project/media/* and everything else to /dispatch.php	apache
Using Alias in Apache ONLY if local directory not present?	apache
Apache 2 Administration Tools on Ubuntu or Windows	apache
Invoking Wine From Apache	apache
How can I setup Apache to serve SVN with this particular URL configuration?	apache
"Why would ""/id"" as a HTTP GET parameter would be a security breach ?"	apache
How to track down CPU intensive requests	apache
"is this true? ""Gzipped items will not have the same etags (even if the content did not change)"""	apache
How to remove a cookie using mod_rewrite	apache
localhost != remote server	apache
"How to put Apache website to 503 ""temporary down""?"	apache
The Current State Of Serving a PHP 5.x App on the Apache, LightTPD & Nginx Web Servers?	apache
Help making my root directory not executable for CGI scripts	apache
Why does my content change when running in Apache XAMPP?	apache
Apache URL Rewriting with N Arguments	apache
How to access images on a directory outside of the web application	apache
how to make apache rewrite this url ?	apache
apache resolving urls before looking in .htaccess	apache
Apache Django URL problem	apache
How can I deny all but one directory name with .htaccess?	apache
Can I use Apache servers for a local network?	apache
Is there a way to force traffic comin from www.abc.com to go to abc.com via htaccess or dns?	apache
What is the best alternative way of montoring apache Active MQ other than using JMX API	apache
Apache basic authentication on Django site	apache
XAMPP on Falshdrive cannot start Apache, MYSQL on WIndows 7	apache
How to redirect based on Accept-Language with Apache / mod_rewrite	apache
Simple rewrite rule for a nginx + apache2 with mod_wsgi	apache
Finding out what user Apache is running as?	apache
apache redirect from non www to www	apache
How can I configure Apache to map  /talk.html?id=77 to the file that is called talk.html?id=77  ?	apache
Problems redirecting old domain to new with Apache and htaccess	apache
IIS 6.0+ equivalent to Apache's content negotation/AddLanguage?	apache
How to redirect requested uri that don't exists to 404 page with Apache?	apache
Apache Whitelist reverse proxy	apache
Map virtual directory to another web server in apache	apache
How to password control access to all urls except one in apache 2	apache
Apache Velocity $ vs $!{}	apache
Apache mod_perl handler/dispatcher returning control to apache.	apache
.htacess mod_rewrite on root directory but need it to skip all other directories	apache
static site apache and dynamic/member site django	apache
Virtual Host points to another Virtual Host - Urgent!	apache
How can I get apache to list a folders contents?	apache
Sub second request time logging	apache
Can I rewrite from subdomain to folder avoiding redirection?	apache
yslow still not giving me an A for expires header in apache httpd even though I added them	apache
If you use https will your url params will be safe from sniffing?	apache
My cgi script can't write to cgi-bin folder of Apache	apache
Difference in website display depending on domain	apache
Apache mod_rewrite %2B and plus (+) signs...	apache
Apache/PHP  serving file multiple times	apache
Apache mod_rewrite a subdomain to a subfolder (via internal redirect)	apache
How we create .htaccess for IIS ? Is it possible ?	apache
Apache .htaccess mod_rewrite and clean urls	apache
mod_rewrite - splitting up arbitary number of terms?	apache
Using mod_rails to host multiple apps under SSL, same domain	apache
htaccess Redirect to same file, but display different URL without having to change internal links?	apache
How to allow only certain files in Apache	apache
[Apache] Creating rewrite rules for multiple urls in the same folder	apache
Permissions to PHP session files	apache
How do I trouble shoot why my rewrite rules aren't being applied by apache?	apache
RewriteCond BackReferencing %N not working?	apache
How do I conditionally add a line to Apache  .htaccess based on the domain?	apache
Manual alternative to mod_deflate	apache
How do I install the Apache FtpServer as a service within Windows 7 (64-bit)?	apache
Why are my file permissions on Apache being reset?	apache
How do you redirect https to http	apache
Redirect requests only if the file is not found?	apache
Does Apache log cancelled downloads?	apache
RewriteRule for mapping x.domain.com to y.domain.com	apache
URL Rewrite Apache locating files	apache
How to configure something like phpmyadmin in windows and linux?	apache
How to set standard encoding in Visual Studio	visual-studio
Visual studio or resharper shortcut to close currently selected file in IDE	visual-studio
Pascal syntax highlight in Visual Studio ?	visual-studio
Visual Studio Attach to Process	visual-studio
Visual Studio - Prevent stopping debugging from closing Internet Explorer	visual-studio
Contextual code generation in Visual C# 2008?	visual-studio
F6 for compiling?	visual-studio
Building a VS2010 project consumes extra resources	visual-studio
C# structural highlighting in Visual Studio 2008	visual-studio
How can I load an image saved in database to Visual Studio ReportViewer 2008?	visual-studio
Permissions Error Registering Assembly	visual-studio
Make Visual Studio understand CamelCase when hitting ctrl and cursor keys	visual-studio
Changing font for member variables in Visual Studio	visual-studio
Determining the port a Visual Studio Web App runs on	visual-studio
Can one access TestContext in an AssemblyCleanup method?	visual-studio
Does Visual Studio have debug symbols available?	visual-studio
How to add and compile for custom 'Platform' switch for visual studio projects?	visual-studio
Is form display dependent on development machine in Visual Studio?	visual-studio
Visual Studio vs. #Develop - Default event handlers	visual-studio
How to unit-test a file writing method with Visual Studio's built-in automated tests?	visual-studio
How to validate an XML file against a schema using Visual Studio 2005	visual-studio
Very slow compile times on Visual Studio	visual-studio
w3Schools gives some basic example for web based languages is there any kind of equiverlent for Studio Basic?	visual-studio
how can i move the cursor in insert mode in viemu (w/o using the arrow keys)?	visual-studio
Per language settings in Visual Studio 2008	visual-studio
how can i add two projects..vs2008	visual-studio
vssettings	visual-studio
visual studio - remove custom control from designer window	visual-studio
Bazaar (bzr) integration with Visual Studio	visual-studio
How to increase the time tooltips remain visible in Visual Studio	visual-studio
How to use app.config with Visual Studio add-in?	visual-studio
How to stop VS2008 trying to compile .ASP pages as Visual Basic?	visual-studio
How should I set up external resources in my project?	visual-studio
Version control of MDF files	visual-studio
Visual Studio Performance Choice - ESXi or Vista?	visual-studio
Make Visual Studio's Find in Files default to the project directory?	visual-studio
What are your most frequently used shortcut keys in visual studio?	visual-studio
How do I fix this Visual Studio keyboard mapping problem?	visual-studio
VSTemplate with build action	visual-studio
Copy always to output directory does not work	visual-studio
What is the optimal VSTF source structure? Are there any best practices?	visual-studio
Awesome Visual Studio Macros	visual-studio
Customizing Visual Studio's Intellisense	visual-studio
How to permanently remove a breakpoint in Visual Studio 2005 /2008 (ASP.NET, C#)	visual-studio
VS2008 debugging with firefox as default browser - how to make the debugger stop/close on exit?	visual-studio
How to configure MSBuild to do some tasks only on release builds?	visual-studio
Project (bin) folder path at compile time?	visual-studio
generation of designer file failed	visual-studio
Visual Studio Tips on getting headers that are used in a given project?	visual-studio
How do I sort my code in Visual Studio 2008?	visual-studio
Can I compile legacy MFC applications with Visual Studio 2008 ?	visual-studio
"Visual Studio Error: The ""GenerateResource"" task failed unexpectedly."	visual-studio
Visual Studio add-on gallery?	visual-studio
DataGridView/ListView - Display in an Outlook style?	visual-studio
IDispose - Visual Studio	visual-studio
"How to use ""macros"" in VisualStudio 2008 build events?"	visual-studio
What is the purpose of Browse Information generated by Visual Studio	visual-studio
Getting started with Visual Studio 2008 plug-in / add-in development	visual-studio
Turn off auto formatting in Visual Studio	visual-studio
Showing generic class eg Table<String> in xml comments in visual studio.	visual-studio
Why would my ASP.NET project run on the development server when not among the startup projects?	visual-studio
Screen resolution for programming	visual-studio
How to get rid validation warnings	visual-studio
Optimization settings in VS	visual-studio
Which projects do you include in your solutions	visual-studio
Will installing the Visual Studio 2010 +Oslo CTP screw my Visual Studio 08 install?	visual-studio
Can Visual Studio Automatically Expand Text with a Code Snippet?	visual-studio
Integrating Visual Studio Test Project with Cruise Control	visual-studio
DebuggerDisplay Attribute does not work	visual-studio
Visual Studio 2005: All projects in solution explorer expanded on first opening of solution	visual-studio
Visual Studio support for new C / C++ standards?	visual-studio
How to use Office from Visual Studio C#?	visual-studio
Best way to license Microsoft software as a very small developer	visual-studio
Auto-sync Visual Studio's Class View	visual-studio
"Visual Studio: Is there a ""move class to different namespace"" refactoring?"	visual-studio
Visual Studio color theme	visual-studio
Create a WPF library in Visual Studio Express	visual-studio
Can optimizations affect the ability to debug a VC++ app using its PDB?	visual-studio
Is there a way to run an outside executable after a SPECIFIC solution is built in Visual Studio 2008?	visual-studio
How can i have two concurrent web apps running on VS2008/VSS8.0/ASP.NET/IIS for a trunk and branch version?	visual-studio
Is there a way to force Visual Studio 2008 (or below) to use a spellchecker for comments?	visual-studio
How to Autogenerate multiple getters/setters or accessors in Visual Studio	visual-studio
What References Does Visual Studio Add When I Accidentally Click Add New Winform?	visual-studio
404 Problem Running Visual Studio ASP.NET Unit Test	visual-studio
Where does the Toolbar Metadata live in Visual Studio on the Filesystem	visual-studio
"Is there a way to do ""intraWord"" text navigation in VS?"	visual-studio
visual studio 2008 - is hand coding ~80% of the time too much?	visual-studio
Are there any drawbacks to running Visual Studio remotely?	visual-studio
Does it worth switching from Visual Studio 2005 to Visual Studio 2008 ?	visual-studio
VIsual Studio - How to change the return value of a method in the debugger ?	visual-studio
ReSharper sluggishness	visual-studio
I don't get the concept of Visual Studio Projects and Solutions.	visual-studio
how to change source file encoding in csharp project (visual studio / msbuild machine)?	visual-studio
How to put BIDS solutions under source control?	visual-studio
Add references to project when control dropped from Visual Studio 2008 toolbox	visual-studio
Remove elusive keyboard binding in visual studio	visual-studio
"How to remove ""VsDebuggerCausalityData"" data from SOAP message?"	visual-studio
Output library project XML to asp.net bin folder on build?	visual-studio
What Visual Studio add-ins do you use?	visual-studio
Attaching to child process automatically in Visual Studio	visual-studio
Mixing Static Libraries of C Code  built from different versions of Visual Studio 2002 and later	visual-studio
Do you use any of the features in the various Visual Studio 2008 Team editions?	visual-studio
Is there anyway to remove Design (and Split) views from Visual Studio 2005/2008?	visual-studio
Using VS 2005 to design abstract forms	visual-studio
T4 not working in Visual Studio 2008	visual-studio
Add codebase as reference instead of copy Visual Studio	visual-studio
Replacing typelibs for imports	visual-studio
What's an easy way to access prebuild macros such as $(SolutionDir) and $(DevEnvDir) from code in C#?	visual-studio
Shared files between projects in Visual Studio	visual-studio
Change default XML comment snippet in Visual Studio	visual-studio
Visual Studio Unit Test - The member specified could not be found.	visual-studio
MSBuild directory structure limit workarounds	visual-studio
Vertical line after a certain amount characters in Visual Studio	visual-studio
Can Visual Studio be made to debug child processes like WinDBG?	visual-studio
AnkhSVN Cannot Connect Due to Proxy	visual-studio
Visual Studio 2008 macro to switch between header and source files?	visual-studio
Visual Studio plug-in that mimics eclipse environment	visual-studio
VS2005: Assembly '<assembly>' is incorrectly specified as a file.	visual-studio
Which Visual Studio Color Theme?	visual-studio
Displaying Japanese fonts in source code using Visual Studio	visual-studio
Best Visual Studio 2008 Debugging Tutorial?	visual-studio
Hidden Features of Visual Studio (2005-2008)?	visual-studio
Tips and tricks for working with Microsoft Visual Studio solutions and project	visual-studio
C# 2008 Express: Project type (.csproj) is not supported by this version of the application.	visual-studio
Any good PowerShell MSBuild tasks?	visual-studio
Collapsible member events in Visual Studio designer	visual-studio
How to profile methods in dependent assemblies in a unit test instrumentation performance session?	visual-studio
Globalizing source code	visual-studio
Case preserving find/replace in Visual Studio	visual-studio
"C++/CLI: linker gives ""resolved token"" for win32 function"	visual-studio
Useful Add-In's or Plug-In's for native Visual Studio developer	visual-studio
Why isn't there a Team Foundation Server Express Edition?	visual-studio
CodeRush for C# issues	visual-studio
Why doesn't 'shell' work in VBscript in VS6?	visual-studio
How can I make a setup that makes my software require administrative priviliges while installation?	visual-studio
How do I get the Visual Studio Load Test Agent to use the servers second CPU	visual-studio
Unable to start debug in Visual Studio 2005	visual-studio
What is a solution folder in visual studio	visual-studio
Visual Studio - New Filter instead of New Folder when using Create Project From Existing Source Wizard	visual-studio
How do you default a new class to public when creating it in Visual Studio?	visual-studio
How do I check the active solution configuration Visual Studio built with at runtime?	visual-studio
How do I customize the auto commenting text in Visual Studio?	visual-studio
VS2010 Extensibility - how different is it?	visual-studio
"""Greedy"" <Delete> and <Backspace> in Visual Studio"	visual-studio
Visual Studio IDE layout tips	visual-studio
Loads of extra space at bottom of class in Visual Studio 2008 C# Express	visual-studio
"Automate ""Attach to Process"" in VS2005/2008"	visual-studio
How to remove, reinstall and/or find info about Visual Studio 2008 hotfixes?	visual-studio
Should the Visual Studio GUI editor be used?	visual-studio
Visual Studio - rewrite / lifespan	visual-studio
